Id,Label,timeset,indegree,outdegree,Degree,weighted indegree,weighted outdegree,Weighted Degree,Eccentricity,closnesscentrality,harmonicclosnesscentrality,betweenesscentrality,Authority,Hub,modularity_class,pageranks,componentnumber,strongcompnum,Cluster,clustering,eigencentrality,Cluter-ID
Meredith Stransky  ,Meredith Stransky  ,,89,89,178,89,89,178,2,0.523311,0.544545,0.000705,0.027919,0.027919,8,0.000904,0,0,0,0.099336,0.70464,0
Katina Gillespi  ,Katina Gillespi  ,,113,113,226,113,113,226,2,0.529973,0.556557,0.001133,0.035572,0.035572,8,0.001107,0,0,0,0.100032,0.897663,0
Carmela Smyers  ,Carmela Smyers  ,,86,86,172,86,86,172,2,0.52249,0.543043,0.000667,0.02669,0.02669,4,0.00088,0,0,0,0.098495,0.673798,0
Huong Polhemus  ,Huong Polhemus  ,,107,107,214,107,107,214,2,0.528292,0.553554,0.001012,0.033562,0.033562,2,0.001057,0,0,0,0.100688,0.847057,0
Floyd Robinett  ,Floyd Robinett  ,,85,85,170,85,85,170,2,0.522216,0.542543,0.000637,0.026645,0.026645,4,0.00087,0,0,0,0.103361,0.6726,0
Daphine Lynn  ,Daphine Lynn  ,,107,107,214,107,107,214,2,0.528292,0.553554,0.001033,0.033298,0.033298,1,0.001058,0,0,0,0.095045,0.840486,0
Pearle Dimeo  ,Pearle Dimeo  ,,87,87,174,87,87,174,2,0.522763,0.543544,0.000697,0.027013,0.027013,4,0.000889,0,0,0,0.093023,0.681948,0
Lucie,Lucie,,90,90,180,90,90,180,2,0.523585,0.545045,0.000725,0.028109,0.028109,4,0.000913,0,0,0,0.098127,0.709466,0
Katherine,Katherine,,91,91,182,91,91,182,2,0.523859,0.545546,0.000735,0.02862,0.02862,8,0.000921,0,0,0,0.101099,0.722305,0
Aneeqa Tanveer,Aneeqa Tanveer,,109,109,218,109,109,218,2,0.528851,0.554555,0.001039,0.034445,0.034445,8,0.001073,0,0,0,0.099728,0.869149,0
Meri Zindage Ho Tum,Meri Zindage Ho Tum,,90,90,180,90,90,180,2,0.523585,0.545045,0.000707,0.028413,0.028413,7,0.000912,0,0,0,0.10362,0.717085,0
Arwen,Arwen,,101,101,202,101,101,202,2,0.526621,0.550551,0.000918,0.031549,0.031549,6,0.001006,0,0,0,0.102772,0.796251,0
Tommy,Tommy,,107,107,214,107,107,214,2,0.528292,0.553554,0.001016,0.033637,0.033637,4,0.001056,0,0,0,0.090813,0.848904,0
Malcum,Malcum,,102,102,204,102,102,204,2,0.526899,0.551051,0.000927,0.032003,0.032003,8,0.001015,0,0,0,0.094156,0.807678,0
Thaliya,Thaliya,,98,98,196,98,98,196,2,0.525789,0.549049,0.000856,0.030659,0.030659,8,0.000981,0,0,0,0.099306,0.773778,0
Akram,Akram,,98,98,196,98,98,196,2,0.525789,0.549049,0.000901,0.030025,0.030025,4,0.000984,0,0,0,0.087313,0.758012,0
Gabriel,Gabriel,,90,90,180,90,90,180,2,0.523585,0.545045,0.000712,0.028403,0.028403,4,0.000912,0,0,0,0.101873,0.716841,0
Mehak,Mehak,,100,100,200,100,100,200,2,0.526344,0.55005,0.000865,0.031666,0.031666,6,0.000996,0,0,0,0.103232,0.799113,0
Ronnie,Ronnie,,120,120,240,120,120,240,2,0.531949,0.56006,0.001308,0.037377,0.037377,7,0.001168,0,0,0,0.09916,0.943301,0
Dashing Hunk II,Dashing Hunk II,,111,111,222,111,111,222,2,0.529412,0.555556,0.001074,0.034976,0.034976,6,0.00109,0,0,0,0.108927,0.882581,0
Kayla,Kayla,,114,114,228,114,114,228,2,0.530255,0.557057,0.001169,0.035397,0.035397,7,0.001117,0,0,0,0.098898,0.893434,0
Saptono,Saptono,,91,91,182,91,91,182,2,0.523859,0.545546,0.00073,0.028698,0.028698,6,0.000921,0,0,0,0.096215,0.724233,0
Usuf Khan,Usuf Khan,,106,106,212,106,106,212,2,0.528013,0.553053,0.00101,0.033208,0.033208,2,0.001049,0,0,0,0.10009,0.838037,0
Faheem Akhtar,Faheem Akhtar,,105,105,210,105,105,210,2,0.527734,0.552553,0.000984,0.032924,0.032924,8,0.00104,0,0,0,0.100183,0.830971,0
Jonathan,Jonathan,,102,102,204,102,102,204,2,0.526899,0.551051,0.000925,0.031982,0.031982,7,0.001014,0,0,0,0.098427,0.807177,0
Ghulam Hyder Samejo,Ghulam Hyder Samejo,,96,96,192,96,96,192,2,0.525237,0.548048,0.00081,0.030126,0.030126,7,0.000963,0,0,0,0.098465,0.760371,0
Khusheed,Khusheed,,114,114,228,114,114,228,2,0.530255,0.557057,0.001146,0.036026,0.036026,1,0.001115,0,0,0,0.098587,0.90899,0
Jasmine,Jasmine,,98,98,196,98,98,196,2,0.525789,0.549049,0.000838,0.03084,0.03084,8,0.00098,0,0,0,0.105618,0.778304,0
Irfan,Irfan,,104,104,208,104,104,208,2,0.527455,0.552052,0.000986,0.032294,0.032294,0,0.001033,0,0,0,0.09522,0.815199,0
Syed,Syed,,98,98,196,98,98,196,2,0.525789,0.549049,0.000808,0.031588,0.031588,5,0.000977,0,0,0,0.104355,0.796865,0
Komal Khan,Komal Khan,,91,91,182,91,91,182,2,0.523859,0.545546,0.000738,0.028425,0.028425,4,0.000921,0,0,0,0.097436,0.717408,0
Mehmood Shah,Mehmood Shah,,117,117,234,117,117,234,2,0.5311,0.558559,0.001234,0.036638,0.036638,6,0.001143,0,0,0,0.103301,0.924606,0
James,James,,102,102,204,102,102,204,2,0.526899,0.551051,0.000963,0.031525,0.031525,0,0.001017,0,0,0,0.097457,0.795852,0
Shehrooz,Shehrooz,,106,106,212,106,106,212,2,0.528013,0.553053,0.001022,0.032989,0.032989,3,0.001049,0,0,0,0.099012,0.832565,0
Sana,Sana,,116,116,232,116,116,232,2,0.530818,0.558058,0.001217,0.036112,0.036112,7,0.001134,0,0,0,0.09925,0.911351,0
Kian,Kian,,97,97,194,97,97,194,2,0.525513,0.548549,0.000807,0.030792,0.030792,4,0.000971,0,0,0,0.106959,0.776946,0
Danny,Danny,,97,97,194,97,97,194,2,0.525513,0.548549,0.000837,0.030454,0.030454,8,0.000972,0,0,0,0.104811,0.76856,0
Layla,Layla,,90,90,180,90,90,180,2,0.523585,0.545045,0.000722,0.028147,0.028147,3,0.000913,0,0,0,0.10362,0.710489,0
Ismael,Ismael,,94,94,188,94,94,188,2,0.524685,0.547047,0.000788,0.029403,0.029403,3,0.000947,0,0,0,0.097003,0.742198,0
Eve,Eve,,102,102,204,102,102,204,2,0.526899,0.551051,0.00093,0.031773,0.031773,8,0.001016,0,0,0,0.102116,0.80204,0
Arshad,Arshad,,99,99,198,99,99,198,2,0.526066,0.54955,0.000841,0.031484,0.031484,8,0.000987,0,0,0,0.106782,0.794427,0
Megan,Megan,,93,93,186,93,93,186,2,0.524409,0.546547,0.000744,0.029441,0.029441,6,0.000937,0,0,0,0.109631,0.742935,0
Ayesha Shah,Ayesha Shah,,99,99,198,99,99,198,2,0.526066,0.54955,0.000876,0.030926,0.030926,4,0.000989,0,0,0,0.101216,0.780598,0
Hamayun Zubair,Hamayun Zubair,,89,89,178,89,89,178,2,0.523311,0.544545,0.000699,0.027899,0.027899,8,0.000904,0,0,0,0.106486,0.704101,0
Misno,Misno,,112,112,224,112,112,224,2,0.529692,0.556056,0.001115,0.035124,0.035124,6,0.001099,0,0,0,0.099582,0.886384,0
Momina,Momina,,102,102,204,102,102,204,2,0.526899,0.551051,0.000923,0.032114,0.032114,3,0.001014,0,0,0,0.09901,0.810501,0
Saad,Saad,,100,100,200,100,100,200,2,0.526344,0.55005,0.000879,0.031508,0.031508,1,0.000997,0,0,0,0.099192,0.795135,0
Erin,Erin,,101,101,202,101,101,202,2,0.526621,0.550551,0.000888,0.031884,0.031884,8,0.001005,0,0,0,0.107327,0.804523,0
Saleem,Saleem,,112,112,224,112,112,224,2,0.529692,0.556056,0.001118,0.035076,0.035076,8,0.001099,0,0,0,0.095721,0.885304,0
Rohan,Rohan,,111,111,222,111,111,222,2,0.529412,0.555556,0.001142,0.034153,0.034153,7,0.001094,0,0,0,0.099099,0.862202,0
Joel,Joel,,106,106,212,106,106,212,2,0.528013,0.553053,0.001003,0.033116,0.033116,6,0.001049,0,0,0,0.101348,0.835818,0
Nadeem,Nadeem,,113,113,226,113,113,226,2,0.529973,0.556557,0.001113,0.035596,0.035596,4,0.001107,0,0,0,0.099083,0.898201,0
Verity,Verity,,109,109,218,109,109,218,2,0.528851,0.554555,0.001101,0.033785,0.033785,1,0.001075,0,0,0,0.095141,0.85291,0
Nadiya,Nadiya,,114,114,228,114,114,228,2,0.530255,0.557057,0.00119,0.035268,0.035268,4,0.001118,0,0,0,0.101227,0.890305,0
Leo,Leo,,107,107,214,107,107,214,2,0.528292,0.553554,0.001023,0.033551,0.033551,0,0.001057,0,0,0,0.099101,0.84675,0
Raja Imran Zafar,Raja Imran Zafar,,110,110,220,110,110,220,2,0.529131,0.555055,0.001116,0.034176,0.034176,6,0.001084,0,0,0,0.096747,0.862568,0
Beatrice,Beatrice,,106,106,212,106,106,212,2,0.528013,0.553053,0.000989,0.033467,0.033467,0,0.001048,0,0,0,0.098293,0.844485,0
Nida Khan,Nida Khan,,102,102,204,102,102,204,2,0.526899,0.551051,0.000925,0.031871,0.031871,1,0.001015,0,0,0,0.105416,0.804435,0
Waqas Nazir,Waqas Nazir,,109,109,218,109,109,218,2,0.528851,0.554555,0.001034,0.034587,0.034587,4,0.001072,0,0,0,0.09701,0.872754,0
Mubashar Baba,Mubashar Baba,,99,99,198,99,99,198,2,0.526066,0.54955,0.000844,0.031457,0.031457,3,0.000987,0,0,0,0.111936,0.793712,0
Stanley,Stanley,,87,87,174,87,87,174,2,0.522763,0.543544,0.000683,0.027129,0.027129,4,0.000888,0,0,0,0.099706,0.68477,0
Mazan Hoot,Mazan Hoot,,104,104,208,104,104,208,3,0.527177,0.551885,0.000969,0.032443,0.032443,8,0.001032,0,0,0,0.098581,0.818813,0
Mustafa Dk,Mustafa Dk,,80,80,160,80,80,160,2,0.520855,0.54004,0.000567,0.025022,0.025022,2,0.000828,0,0,0,0.103165,0.631585,0
Dolcie,Dolcie,,111,111,222,111,111,222,2,0.529412,0.555556,0.001102,0.034754,0.034754,0,0.001091,0,0,0,0.103522,0.877078,0
Rorry,Rorry,,92,92,184,92,92,184,2,0.524134,0.546046,0.000744,0.029011,0.029011,4,0.000929,0,0,0,0.104634,0.732151,0
Nicole,Nicole,,105,105,210,105,105,210,2,0.527734,0.552553,0.000946,0.033546,0.033546,5,0.001038,0,0,0,0.102015,0.846363,0
Elliot,Elliot,,116,116,232,116,116,232,2,0.530818,0.558058,0.001204,0.036502,0.036502,5,0.001133,0,0,0,0.097751,0.921139,0
Mudassar Munir,Mudassar Munir,,87,87,174,87,87,174,2,0.522763,0.543544,0.00068,0.026955,0.026955,0,0.000889,0,0,0,0.101043,0.680472,0
Waqas,Waqas,,87,87,174,87,87,174,2,0.522763,0.543544,0.000667,0.027223,0.027223,1,0.000888,0,0,0,0.105052,0.687115,0
Aymen,Aymen,,95,95,190,95,95,190,2,0.524961,0.547548,0.000781,0.030258,0.030258,4,0.000953,0,0,0,0.101456,0.76352,0
Marcus,Marcus,,109,109,218,109,109,218,2,0.528851,0.554555,0.001058,0.034217,0.034217,6,0.001074,0,0,0,0.098709,0.863561,0
Janice,Janice,,102,102,204,102,102,204,2,0.526899,0.551051,0.000947,0.031664,0.031664,0,0.001016,0,0,0,0.095127,0.799277,0
Danish Saifullah,Danish Saifullah,,108,108,216,108,108,216,2,0.528571,0.554054,0.001045,0.033807,0.033807,8,0.001066,0,0,0,0.102631,0.85331,0
Tanveer,Tanveer,,71,71,142,71,71,142,2,0.518422,0.535536,0.000447,0.022179,0.022179,8,0.000752,0,0,0,0.104225,0.559879,0
Ahsan,Ahsan,,101,101,202,101,101,202,2,0.526621,0.550551,0.000885,0.032075,0.032075,3,0.001004,0,0,0,0.10495,0.80933,0
Cai,Cai,,108,108,216,108,108,216,2,0.528571,0.554054,0.001022,0.034109,0.034109,5,0.001064,0,0,0,0.100381,0.860741,0
Declan,Declan,,106,106,212,106,106,212,2,0.528013,0.553053,0.001008,0.033194,0.033194,8,0.001048,0,0,0,0.097754,0.837765,0
Adeela,Adeela,,102,102,204,102,102,204,2,0.526899,0.551051,0.000898,0.032388,0.032388,1,0.001013,0,0,0,0.100757,0.817232,0
Noor,Noor,,123,123,246,123,123,246,2,0.5328,0.561562,0.001369,0.038447,0.038447,2,0.001193,0,0,0,0.096895,0.970278,0
Ashton,Ashton,,91,91,182,91,91,182,2,0.523859,0.545546,0.00072,0.028778,0.028778,8,0.00092,0,0,0,0.104518,0.726287,0
Erik,Erik,,92,92,184,92,92,184,3,0.523859,0.545879,0.00074,0.029045,0.029045,7,0.000929,0,0,0,0.09914,0.733005,0
Arisha,Arisha,,119,119,238,119,119,238,2,0.531666,0.55956,0.001246,0.037564,0.037564,2,0.001158,0,0,0,0.103262,0.94782,0
Reema,Reema,,92,92,184,92,92,184,2,0.524134,0.546046,0.000758,0.028655,0.028655,8,0.00093,0,0,0,0.100812,0.723355,0
Neha Ch,Neha Ch,,97,97,194,97,97,194,2,0.525513,0.548549,0.00081,0.030766,0.030766,4,0.000971,0,0,0,0.101589,0.776334,0
Shujahat,Shujahat,,97,97,194,97,97,194,2,0.525513,0.548549,0.000795,0.030942,0.030942,6,0.00097,0,0,0,0.102448,0.78073,0
Rehman,Rehman,,87,87,174,87,87,174,2,0.522763,0.543544,0.000659,0.027658,0.027658,7,0.000886,0,0,0,0.106121,0.697892,0
Barashna Yawar,Barashna Yawar,,106,106,212,106,106,212,3,0.527734,0.552886,0.00098,0.033498,0.033498,6,0.001047,0,0,0,0.10584,0.845311,0
Levi,Levi,,115,115,230,115,115,230,2,0.530536,0.557558,0.001158,0.036211,0.036211,7,0.001124,0,0,0,0.102517,0.913783,0
Aurangzaib,Aurangzaib,,82,82,164,82,82,164,2,0.521399,0.541041,0.000596,0.025678,0.025678,3,0.000845,0,0,0,0.104788,0.648175,0
Younus,Younus,,104,104,208,104,104,208,2,0.527455,0.552052,0.000948,0.032714,0.032714,8,0.001031,0,0,0,0.102128,0.825579,0
Brittney Mazzella  ,Brittney Mazzella  ,,116,116,232,116,116,232,2,0.530818,0.558058,0.001134,0.037317,0.037317,1,0.00113,0,0,0,0.107646,0.941286,0
Sharika Aiken  ,Sharika Aiken  ,,104,104,208,104,104,208,2,0.527455,0.552052,0.000989,0.032487,0.032487,0,0.001032,0,0,0,0.093353,0.819906,0
Oren Mccaffrey  ,Oren Mccaffrey  ,,99,99,198,99,99,198,2,0.526066,0.54955,0.000885,0.030733,0.030733,2,0.00099,0,0,0,0.101835,0.77571,0
Trinh Gines  ,Trinh Gines  ,,113,113,226,113,113,226,2,0.529973,0.556557,0.001127,0.035686,0.035686,7,0.001107,0,0,0,0.10019,0.900437,0
Xavier,Xavier,,98,98,196,98,98,196,2,0.525789,0.549049,0.000842,0.030912,0.030912,2,0.00098,0,0,0,0.100147,0.780019,0
Kimberley,Kimberley,,106,106,212,106,106,212,2,0.528013,0.553053,0.000968,0.033746,0.033746,7,0.001046,0,0,0,0.104043,0.8515,0
Callum,Callum,,96,96,192,96,96,192,2,0.525237,0.548048,0.000828,0.030064,0.030064,0,0.000964,0,0,0,0.096272,0.758778,0
Donald,Donald,,113,113,226,113,113,226,2,0.529973,0.556557,0.001153,0.035204,0.035204,8,0.001109,0,0,0,0.104456,0.888512,0
Affaan,Affaan,,114,114,228,114,114,228,2,0.530255,0.557057,0.001174,0.035626,0.035626,1,0.001117,0,0,0,0.099053,0.899045,0
Eloise,Eloise,,99,99,198,99,99,198,2,0.526066,0.54955,0.000846,0.031535,0.031535,2,0.000987,0,0,0,0.102865,0.795652,0
Gomez,Gomez,,98,98,196,98,98,196,2,0.525789,0.549049,0.000839,0.030837,0.030837,2,0.00098,0,0,0,0.106249,0.778265,0
Jakub,Jakub,,85,85,170,85,85,170,2,0.522216,0.542543,0.000656,0.026345,0.026345,4,0.000872,0,0,0,0.094958,0.665067,0
Hari Kuncoro,Hari Kuncoro,,95,95,190,95,95,190,2,0.524961,0.547548,0.000804,0.02986,0.02986,4,0.000955,0,0,0,0.090258,0.753594,0
Marco,Marco,,117,117,234,117,117,234,2,0.5311,0.558559,0.001251,0.036494,0.036494,2,0.001143,0,0,0,0.097554,0.921072,0
Isabelle,Isabelle,,109,109,218,109,109,218,2,0.528851,0.554555,0.00103,0.034461,0.034461,8,0.001072,0,0,0,0.102786,0.869597,0
Qotadah,Qotadah,,102,102,204,102,102,204,2,0.526899,0.551051,0.000927,0.031977,0.031977,0,0.001014,0,0,0,0.099981,0.806981,0
Muhammad Shahzain,Muhammad Shahzain,,121,121,242,121,121,242,2,0.532232,0.560561,0.001292,0.038119,0.038119,6,0.001175,0,0,0,0.099036,0.96183,0
Jesse,Jesse,,113,113,226,113,113,226,2,0.529973,0.556557,0.001101,0.036038,0.036038,2,0.001105,0,0,0,0.105247,0.909258,0
Mia,Mia,,98,98,196,98,98,196,2,0.525789,0.549049,0.000827,0.031036,0.031036,1,0.000979,0,0,0,0.107721,0.783111,0
Kai,Kai,,94,94,188,94,94,188,2,0.524685,0.547047,0.000764,0.029791,0.029791,6,0.000945,0,0,0,0.1089,0.751719,0
Shafaq,Shafaq,,95,95,190,95,95,190,2,0.524961,0.547548,0.000799,0.029821,0.029821,3,0.000955,0,0,0,0.101904,0.752608,0
Luisa,Luisa,,112,112,224,112,112,224,2,0.529692,0.556056,0.001111,0.035117,0.035117,0,0.001099,0,0,0,0.104569,0.886139,0
Oscar,Oscar,,114,114,228,114,114,228,2,0.530255,0.557057,0.001177,0.035557,0.035557,8,0.001117,0,0,0,0.098587,0.897399,0
Zainab,Zainab,,98,98,196,98,98,196,2,0.525789,0.549049,0.000838,0.031019,0.031019,2,0.000979,0,0,0,0.102462,0.782734,0
Abdul Malik,Abdul Malik,,92,92,184,92,92,184,2,0.524134,0.546046,0.000755,0.028813,0.028813,8,0.00093,0,0,0,0.102962,0.727178,0
Saurez,Saurez,,100,100,200,100,100,200,2,0.526344,0.55005,0.000842,0.032031,0.032031,7,0.000995,0,0,0,0.104646,0.808036,0
Chandra,Chandra,,111,111,222,111,111,222,2,0.529412,0.555556,0.00109,0.034873,0.034873,3,0.00109,0,0,0,0.103522,0.880066,0
Hassan Gull,Hassan Gull,,95,95,190,95,95,190,2,0.524961,0.547548,0.000793,0.030012,0.030012,4,0.000954,0,0,0,0.096976,0.757282,0
George,George,,98,98,196,98,98,196,2,0.525789,0.549049,0.00087,0.030448,0.030448,3,0.000982,0,0,0,0.10141,0.768607,0
Sylvia,Sylvia,,125,125,250,125,125,250,2,0.533369,0.562563,0.001436,0.038725,0.038725,6,0.001211,0,0,0,0.096903,0.977398,0
Dulmatin,Dulmatin,,100,100,200,100,100,200,2,0.526344,0.55005,0.00089,0.031336,0.031336,8,0.000997,0,0,0,0.099394,0.790797,0
Haider,Haider,,100,100,200,100,100,200,2,0.526344,0.55005,0.000883,0.031486,0.031486,1,0.000997,0,0,0,0.101818,0.79459,0
Zoe,Zoe,,115,115,230,115,115,230,2,0.530536,0.557558,0.001163,0.036307,0.036307,8,0.001124,0,0,0,0.097941,0.916175,0
Kashif,Kashif,,92,92,184,92,92,184,2,0.524134,0.546046,0.000758,0.028833,0.028833,4,0.00093,0,0,0,0.096751,0.727704,0
Billy,Billy,,90,90,180,90,90,180,2,0.523585,0.545045,0.000725,0.028159,0.028159,5,0.000913,0,0,0,0.093633,0.710683,0
Bilaal,Bilaal,,111,111,222,111,111,222,2,0.529412,0.555556,0.001144,0.034278,0.034278,0,0.001093,0,0,0,0.094676,0.865171,0
Carlo,Carlo,,122,122,244,122,122,244,2,0.532516,0.561061,0.001296,0.038713,0.038713,5,0.001182,0,0,0,0.098903,0.976699,0
Armaan,Armaan,,113,113,226,113,113,226,2,0.529973,0.556557,0.001164,0.035233,0.035233,2,0.001109,0,0,0,0.095133,0.889263,0
Ryan,Ryan,,100,100,200,100,100,200,2,0.526344,0.55005,0.000869,0.0317,0.0317,7,0.000996,0,0,0,0.09899,0.799952,0
Yazdaan,Yazdaan,,108,108,216,108,108,216,2,0.528571,0.554054,0.001012,0.034416,0.034416,1,0.001063,0,0,0,0.094496,0.868248,0
Abdul Rohim,Abdul Rohim,,105,105,210,105,105,210,2,0.527734,0.552553,0.000962,0.03326,0.03326,4,0.001039,0,0,0,0.100733,0.839314,0
Sajjad Ali,Sajjad Ali,,100,100,200,100,100,200,2,0.526344,0.55005,0.000877,0.031543,0.031543,3,0.000997,0,0,0,0.106263,0.796088,0
Aris Munandar,Aris Munandar,,93,93,186,93,93,186,3,0.524134,0.54638,0.000775,0.029067,0.029067,0,0.000939,0,0,0,0.104956,0.733602,0
Khushi,Khushi,,121,121,242,121,121,242,2,0.532232,0.560561,0.001286,0.038349,0.038349,8,0.001174,0,0,0,0.100413,0.967648,0
Nathan,Nathan,,105,105,210,105,105,210,3,0.527455,0.552386,0.000955,0.033442,0.033442,5,0.001038,0,0,0,0.099451,0.843736,0
Nate,Nate,,91,91,182,91,91,182,2,0.523859,0.545546,0.000724,0.028746,0.028746,1,0.000921,0,0,0,0.102076,0.725378,0
Emila,Emila,,88,88,176,88,88,176,2,0.523037,0.544044,0.00065,0.028152,0.028152,7,0.000894,0,0,0,0.111285,0.7103,0
Kamal Kami,Kamal Kami,,97,97,194,97,97,194,2,0.525513,0.548549,0.000821,0.03076,0.03076,4,0.000971,0,0,0,0.098368,0.776227,0
Ivy,Ivy,,94,94,188,94,94,188,2,0.524685,0.547047,0.00078,0.029662,0.029662,6,0.000946,0,0,0,0.100892,0.748549,0
Scott,Scott,,93,93,186,93,93,186,2,0.524409,0.546547,0.000772,0.029183,0.029183,1,0.000938,0,0,0,0.09654,0.736569,0
Zeehsan Ahmed,Zeehsan Ahmed,,110,110,220,110,110,220,2,0.529131,0.555055,0.001083,0.034579,0.034579,7,0.001082,0,0,0,0.09608,0.872635,0
Yousaf,Yousaf,,104,104,208,104,104,208,2,0.527455,0.552052,0.000955,0.032866,0.032866,1,0.001031,0,0,0,0.101195,0.829366,0
Javeed,Javeed,,97,97,194,97,97,194,2,0.525513,0.548549,0.000827,0.030567,0.030567,4,0.000971,0,0,0,0.1061,0.771427,0
Zack,Zack,,126,126,252,126,126,252,2,0.533654,0.563063,0.001425,0.039628,0.039628,8,0.001218,0,0,0,0.100825,1,0
Amir Jamil,Amir Jamil,,98,98,196,98,98,196,2,0.525789,0.549049,0.000848,0.030814,0.030814,3,0.00098,0,0,0,0.095519,0.777674,0
Hermione,Hermione,,95,95,190,95,95,190,2,0.524961,0.547548,0.00079,0.029978,0.029978,7,0.000954,0,0,0,0.102352,0.756544,0
Subhaan,Subhaan,,122,122,244,122,122,244,2,0.532516,0.561061,0.001301,0.038871,0.038871,6,0.001182,0,0,0,0.096328,0.980643,0
Muhib Awais,Muhib Awais,,111,111,222,111,111,222,2,0.529412,0.555556,0.001101,0.034709,0.034709,8,0.001091,0,0,0,0.099427,0.875956,0
Qadeer,Qadeer,,90,90,180,90,90,180,2,0.523585,0.545045,0.000736,0.028062,0.028062,5,0.000914,0,0,0,0.096879,0.708353,0
Niamh,Niamh,,106,106,212,106,106,212,2,0.528013,0.553053,0.001012,0.03314,0.03314,1,0.001048,0,0,0,0.090027,0.836378,0
Zahid Khalil,Zahid Khalil,,104,104,208,104,104,208,2,0.527455,0.552052,0.000966,0.032638,0.032638,4,0.001031,0,0,0,0.095967,0.823729,0
Ajay,Ajay,,101,101,202,101,101,202,2,0.526621,0.550551,0.000889,0.031848,0.031848,1,0.001005,0,0,0,0.101188,0.803667,0
Ahmed Naqash,Ahmed Naqash,,90,90,180,90,90,180,2,0.523585,0.545045,0.000713,0.028432,0.028432,6,0.000912,0,0,0,0.101873,0.717515,0
Sameer Ahmed,Sameer Ahmed,,92,92,184,92,92,184,2,0.524134,0.546046,0.000748,0.028957,0.028957,3,0.000929,0,0,0,0.105112,0.730777,0
Mula,Mula,,117,117,234,117,117,234,2,0.5311,0.558559,0.001198,0.03698,0.03698,5,0.001141,0,0,0,0.10389,0.932999,0
Osama,Osama,,98,98,196,98,98,196,2,0.525789,0.549049,0.00085,0.030813,0.030813,1,0.00098,0,0,0,0.097623,0.777631,0
Aiza,Aiza,,102,102,204,102,102,204,2,0.526899,0.551051,0.000904,0.03237,0.03237,7,0.001013,0,0,0,0.103669,0.816656,0
Asim,Asim,,102,102,204,102,102,204,3,0.526621,0.550884,0.000909,0.032211,0.032211,5,0.001014,0,0,0,0.102504,0.812764,0
Jarryullah,Jarryullah,,97,97,194,97,97,194,2,0.525513,0.548549,0.000823,0.030613,0.030613,4,0.000971,0,0,0,0.096005,0.772523,0
Arshiya,Arshiya,,110,110,220,110,110,220,2,0.529131,0.555055,0.001061,0.034665,0.034665,6,0.001082,0,0,0,0.102919,0.874705,0
Rhys,Rhys,,107,107,214,107,107,214,2,0.528292,0.553554,0.001018,0.033551,0.033551,7,0.001057,0,0,0,0.104391,0.84668,0
Sanam,Sanam,,107,107,214,107,107,214,2,0.528292,0.553554,0.001071,0.032993,0.032993,7,0.00106,0,0,0,0.097866,0.832912,0
Damian,Damian,,101,101,202,101,101,202,2,0.526621,0.550551,0.000893,0.031875,0.031875,8,0.001005,0,0,0,0.101782,0.80439,0
Mishaal,Mishaal,,92,92,184,92,92,184,2,0.524134,0.546046,0.000757,0.028744,0.028744,7,0.00093,0,0,0,0.094123,0.725447,0
Annabelle,Annabelle,,92,92,184,92,92,184,2,0.524134,0.546046,0.000737,0.029153,0.029153,0,0.000928,0,0,0,0.106546,0.735727,0
Tilly,Tilly,,101,101,202,101,101,202,2,0.526621,0.550551,0.000892,0.031987,0.031987,5,0.001005,0,0,0,0.102574,0.807126,0
Aslam,Aslam,,112,112,224,112,112,224,2,0.529692,0.556056,0.001149,0.034723,0.034723,4,0.001101,0,0,0,0.09749,0.876378,0
Malik Farooq,Malik Farooq,,109,109,218,109,109,218,2,0.528851,0.554555,0.001058,0.034356,0.034356,1,0.001073,0,0,0,0.09667,0.866903,0
Laurance,Laurance,,100,100,200,100,100,200,2,0.526344,0.55005,0.000856,0.031852,0.031852,8,0.000996,0,0,0,0.108687,0.803593,0
Ashwariya,Ashwariya,,99,99,198,99,99,198,2,0.526066,0.54955,0.000862,0.031191,0.031191,8,0.000988,0,0,0,0.101835,0.787173,0
Yasir Mehmood,Yasir Mehmood,,101,101,202,101,101,202,2,0.526621,0.550551,0.000944,0.0314,0.0314,8,0.001007,0,0,0,0.087525,0.79251,0
Keirra,Keirra,,96,96,192,96,96,192,2,0.525237,0.548048,0.00082,0.030206,0.030206,4,0.000963,0,0,0,0.095833,0.762261,0
Frieda,Frieda,,92,92,184,92,92,184,2,0.524134,0.546046,0.000729,0.029144,0.029144,4,0.000928,0,0,0,0.106068,0.735449,0
Millie,Millie,,102,102,204,102,102,204,2,0.526899,0.551051,0.000917,0.032166,0.032166,6,0.001014,0,0,0,0.10464,0.811619,0
Awais,Awais,,106,106,212,106,106,212,2,0.528013,0.553053,0.000974,0.033606,0.033606,8,0.001047,0,0,0,0.103863,0.847866,0
Shemeka,Shemeka,,107,107,214,107,107,214,2,0.528292,0.553554,0.00102,0.033774,0.033774,7,0.001056,0,0,0,0.09769,0.852254,0
Ijaz Ahmed,Ijaz Ahmed,,101,101,202,101,101,202,2,0.526621,0.550551,0.000888,0.032018,0.032018,7,0.001005,0,0,0,0.103762,0.807875,0
Tristan,Tristan,,109,109,218,109,109,218,2,0.528851,0.554555,0.001032,0.034522,0.034522,2,0.001073,0,0,0,0.105165,0.871095,0
Muzayin Abdul Wahab,Muzayin Abdul Wahab,,116,116,232,116,116,232,2,0.530818,0.558058,0.001193,0.036475,0.036475,7,0.001133,0,0,0,0.102099,0.92037,0
Anees,Anees,,110,110,220,110,110,220,2,0.529131,0.555055,0.001123,0.03392,0.03392,5,0.001085,0,0,0,0.096247,0.856277,0
Augustina,Augustina,,81,81,162,81,81,162,2,0.521127,0.540541,0.000572,0.025503,0.025503,3,0.000836,0,0,0,0.105247,0.64364,0
Haseeb Ali,Haseeb Ali,,99,99,198,99,99,198,2,0.526066,0.54955,0.00087,0.031195,0.031195,0,0.000989,0,0,0,0.09833,0.787257,0
Azhari Husin,Azhari Husin,,104,104,208,104,104,208,2,0.527455,0.552052,0.000965,0.032539,0.032539,6,0.001032,0,0,0,0.101382,0.821263,0
Alvaro,Alvaro,,112,112,224,112,112,224,2,0.529692,0.556056,0.001083,0.035478,0.035478,7,0.001098,0,0,0,0.105051,0.895273,0
Abdullah Sunata,Abdullah Sunata,,86,86,172,86,86,172,2,0.52249,0.543043,0.000648,0.027072,0.027072,1,0.000878,0,0,0,0.101778,0.683275,0
Zubaida,Zubaida,,91,91,182,91,91,182,2,0.523859,0.545546,0.000725,0.028699,0.028699,8,0.000921,0,0,0,0.103053,0.724219,0
Atif Noor,Atif Noor,,116,116,232,116,116,232,2,0.530818,0.558058,0.001228,0.035921,0.035921,1,0.001135,0,0,0,0.104948,0.906658,0
Brooke,Brooke,,87,87,174,87,87,174,2,0.522763,0.543544,0.000655,0.027477,0.027477,8,0.000887,0,0,0,0.109864,0.693458,0
Adung,Adung,,84,84,168,84,84,168,3,0.521671,0.541875,0.000596,0.026874,0.026874,8,0.00086,0,0,0,0.102123,0.678048,0
AVA,AVA,,116,116,232,116,116,232,2,0.530818,0.558058,0.001197,0.03639,0.03639,6,0.001133,0,0,0,0.1003,0.918307,0
Alfred,Alfred,,118,118,236,118,118,236,2,0.531383,0.559059,0.001217,0.037398,0.037398,5,0.001149,0,0,0,0.10213,0.943621,0
Frazer,Frazer,,111,111,222,111,111,222,2,0.529412,0.555556,0.001101,0.034903,0.034903,4,0.00109,0,0,0,0.099591,0.880803,0
Yi Cook  ,Yi Cook  ,,90,90,180,90,90,180,2,0.523585,0.545045,0.000704,0.02856,0.02856,8,0.000912,0,0,0,0.101873,0.720665,0
Lakendra Lasiter  ,Lakendra Lasiter  ,,107,107,214,107,107,214,2,0.528292,0.553554,0.00102,0.033644,0.033644,5,0.001057,0,0,0,0.100159,0.84907,0
Hobert Sagers  ,Hobert Sagers  ,,80,80,160,80,80,160,2,0.520855,0.54004,0.000562,0.025215,0.025215,4,0.000827,0,0,0,0.087342,0.636414,0
Janita Thelen  ,Janita Thelen  ,,113,113,226,113,113,226,2,0.529973,0.556557,0.001104,0.035742,0.035742,2,0.001106,0,0,0,0.105247,0.90188,0
Beth Walraven  ,Beth Walraven  ,,108,108,216,108,108,216,2,0.528571,0.554054,0.001066,0.033445,0.033445,4,0.001067,0,0,0,0.098823,0.844249,0
Layton,Layton,,102,102,204,102,102,204,2,0.526899,0.551051,0.000924,0.032064,0.032064,6,0.001014,0,0,0,0.09901,0.809189,0
Shahzaib Jutt,Shahzaib Jutt,,94,94,188,94,94,188,3,0.524409,0.54688,0.000765,0.029701,0.029701,0,0.000946,0,0,0,0.102951,0.749485,0
Aima,Aima,,109,109,218,109,109,218,2,0.528851,0.554555,0.001043,0.03457,0.03457,6,0.001072,0,0,0,0.09684,0.872301,0
Marwan,Marwan,,103,103,206,103,103,206,2,0.527177,0.551552,0.000934,0.032492,0.032492,2,0.001022,0,0,0,0.100133,0.819954,0
Mhammad Nouman,Mhammad Nouman,,102,102,204,102,102,204,2,0.526899,0.551051,0.000956,0.031617,0.031617,8,0.001016,0,0,0,0.098233,0.79815,0
Fredrick,Fredrick,,110,110,220,110,110,220,2,0.529131,0.555055,0.00106,0.034765,0.034765,4,0.001081,0,0,0,0.103253,0.877269,0
Jason,Jason,,108,108,216,108,108,216,2,0.528571,0.554054,0.001051,0.033758,0.033758,4,0.001066,0,0,0,0.09865,0.852013,0
Vidiya,Vidiya,,96,96,192,96,96,192,2,0.525237,0.548048,0.000821,0.03014,0.03014,2,0.000964,0,0,0,0.095395,0.760687,0
Mirza Khan,Mirza Khan,,120,120,240,120,120,240,2,0.531949,0.56006,0.001286,0.037577,0.037577,4,0.001167,0,0,0,0.101681,0.948288,0
Sardar Saad,Sardar Saad,,107,107,214,107,107,214,2,0.528292,0.553554,0.001047,0.033167,0.033167,2,0.001059,0,0,0,0.09963,0.837206,0
Lilly,Lilly,,101,101,202,101,101,202,2,0.526621,0.550551,0.00094,0.031177,0.031177,2,0.001008,0,0,0,0.100396,0.787059,0
Taha Sheikh,Taha Sheikh,,102,102,204,102,102,204,2,0.526899,0.551051,0.000927,0.031855,0.031855,4,0.001015,0,0,0,0.102116,0.803989,0
Homer,Homer,,108,108,216,108,108,216,2,0.528571,0.554054,0.001004,0.034304,0.034304,5,0.001064,0,0,0,0.10713,0.865564,0
Hanna,Hanna,,105,105,210,105,105,210,2,0.527734,0.552553,0.000971,0.033054,0.033054,0,0.001039,0,0,0,0.106777,0.834083,0
Jamil,Jamil,,109,109,218,109,109,218,2,0.528851,0.554555,0.001027,0.034647,0.034647,6,0.001072,0,0,0,0.104315,0.8741,0
Umair Hassan,Umair Hassan,,117,117,234,117,117,234,2,0.5311,0.558559,0.001219,0.036808,0.036808,6,0.001141,0,0,0,0.104038,0.928769,0
Evelina,Evelina,,110,110,220,110,110,220,2,0.529131,0.555055,0.001089,0.034354,0.034354,5,0.001083,0,0,0,0.10025,0.867044,0
Darca,Darca,,79,79,158,79,79,158,2,0.520584,0.53954,0.000546,0.024798,0.024798,6,0.00082,0,0,0,0.098669,0.625863,0
Sarfaz,Sarfaz,,101,101,202,101,101,202,2,0.526621,0.550551,0.000901,0.031696,0.031696,8,0.001006,0,0,0,0.104554,0.799909,0
Mason,Mason,,101,101,202,101,101,202,2,0.526621,0.550551,0.000916,0.031379,0.031379,0,0.001007,0,0,0,0.103762,0.792079,0
Frankie,Frankie,,95,95,190,95,95,190,2,0.524961,0.547548,0.00081,0.02978,0.02978,2,0.000955,0,0,0,0.098992,0.751529,0
Miya,Miya,,93,93,186,93,93,186,2,0.524409,0.546547,0.000764,0.02914,0.02914,4,0.000938,0,0,0,0.103319,0.73546,0
Arshad Khan,Arshad Khan,,102,102,204,102,102,204,2,0.526899,0.551051,0.000972,0.03136,0.03136,8,0.001017,0,0,0,0.098622,0.79169,0
Maud,Maud,,110,110,220,110,110,220,2,0.529131,0.555055,0.001095,0.034412,0.034412,7,0.001083,0,0,0,0.096747,0.86846,0
Rana Jhangir Khan,Rana Jhangir Khan,,105,105,210,105,105,210,2,0.527734,0.552553,0.00099,0.032793,0.032793,4,0.00104,0,0,0,0.095604,0.827643,0
Hasnain Niazi,Hasnain Niazi,,92,92,184,92,92,184,2,0.524134,0.546046,0.000729,0.029194,0.029194,2,0.000928,0,0,0,0.105829,0.736698,0
Daniella,Daniella,,100,100,200,100,100,200,2,0.526344,0.55005,0.000876,0.031665,0.031665,8,0.000996,0,0,0,0.09697,0.798982,0
Jacklyn,Jacklyn,,108,108,216,108,108,216,2,0.528571,0.554054,0.001007,0.034457,0.034457,7,0.001063,0,0,0,0.102111,0.869391,0
Iqbal Huseini,Iqbal Huseini,,90,90,180,90,90,180,2,0.523585,0.545045,0.000723,0.028259,0.028259,4,0.000912,0,0,0,0.097378,0.713193,0
Ellie,Ellie,,77,77,154,77,77,154,2,0.520042,0.538539,0.000508,0.024517,0.024517,8,0.000801,0,0,0,0.10663,0.618685,0
Yaseen Ahmed,Yaseen Ahmed,,99,99,198,99,99,198,2,0.526066,0.54955,0.000866,0.031031,0.031031,2,0.000989,0,0,0,0.104308,0.783235,0
Faizan Sheikh,Faizan Sheikh,,99,99,198,99,99,198,2,0.526066,0.54955,0.00087,0.030985,0.030986,8,0.000989,0,0,0,0.109462,0.782018,0
Mian Tahir,Mian Tahir,,110,110,220,110,110,220,2,0.529131,0.555055,0.001051,0.034902,0.034902,1,0.00108,0,0,0,0.101918,0.88064,0
Yusuf,Yusuf,,95,95,190,95,95,190,3,0.524685,0.547381,0.000794,0.02979,0.02979,4,0.000955,0,0,0,0.106159,0.751895,0
Abdullah Sungkar,Abdullah Sungkar,,120,120,240,120,120,240,2,0.531949,0.56006,0.001293,0.037773,0.037773,7,0.001167,0,0,0,0.093557,0.953123,0
Tanveer Ghumman,Tanveer Ghumman,,106,106,212,106,106,212,2,0.528013,0.553053,0.001007,0.033156,0.033156,8,0.001048,0,0,0,0.098473,0.836826,0
Dwayne,Dwayne,,106,106,212,106,106,212,2,0.528013,0.553053,0.001,0.033167,0.033167,6,0.001049,0,0,0,0.105301,0.837024,0
Zach,Zach,,97,97,194,97,97,194,2,0.525513,0.548549,0.000842,0.030431,0.030431,8,0.000972,0,0,0,0.102448,0.768021,0
Amman,Amman,,111,111,222,111,111,222,3,0.529131,0.555389,0.001103,0.034694,0.034694,2,0.001091,0,0,0,0.103194,0.87564,0
Aidan,Aidan,,100,100,200,100,100,200,2,0.526344,0.55005,0.000893,0.031264,0.031264,1,0.000998,0,0,0,0.100808,0.789135,0
Wyat,Wyat,,94,94,188,94,94,188,2,0.524685,0.547047,0.000828,0.02888,0.02888,2,0.000949,0,0,0,0.09197,0.729117,0
Oliver,Oliver,,112,112,224,112,112,224,2,0.529692,0.556056,0.001089,0.035534,0.035534,0,0.001098,0,0,0,0.101995,0.896592,0
De Gea,De Gea,,99,99,198,99,99,198,2,0.526066,0.54955,0.00086,0.031223,0.031223,8,0.000988,0,0,0,0.100804,0.787942,0
Zulkarnaen,Zulkarnaen,,107,107,214,107,107,214,2,0.528292,0.553554,0.001014,0.033726,0.033726,5,0.001056,0,0,0,0.093987,0.851041,0
Leaon,Leaon,,90,90,180,90,90,180,2,0.523585,0.545045,0.000735,0.027993,0.027993,2,0.000914,0,0,0,0.100375,0.706615,0
Rameeza,Rameeza,,96,96,192,96,96,192,2,0.525237,0.548048,0.000802,0.030362,0.030362,3,0.000962,0,0,0,0.101974,0.766236,0
Sion,Sion,,95,95,190,95,95,190,2,0.524961,0.547548,0.00081,0.029791,0.029791,5,0.000955,0,0,0,0.098096,0.751849,0
Albert,Albert,,86,86,172,86,86,172,2,0.52249,0.543043,0.000678,0.026506,0.026506,7,0.000881,0,0,0,0.104241,0.669156,0
Alexander,Alexander,,81,81,162,81,81,162,2,0.521127,0.540541,0.000566,0.025749,0.025749,8,0.000835,0,0,0,0.09784,0.649787,0
Anya,Anya,,113,113,226,113,113,226,2,0.529973,0.556557,0.001153,0.035271,0.035271,3,0.001108,0,0,0,0.094185,0.890158,0
Nabeeha,Nabeeha,,105,105,210,105,105,210,2,0.527734,0.552553,0.000982,0.033014,0.033014,8,0.00104,0,0,0,0.099451,0.833109,0
Amber,Amber,,108,108,216,108,108,216,2,0.528571,0.554054,0.001035,0.034007,0.034007,2,0.001065,0,0,0,0.094496,0.858215,0
Owais Arain,Owais Arain,,102,102,204,102,102,204,2,0.526899,0.551051,0.000959,0.031478,0.031478,5,0.001017,0,0,0,0.096486,0.794605,0
Nicholas,Nicholas,,101,101,202,101,101,202,2,0.526621,0.550551,0.000887,0.031979,0.031979,2,0.001005,0,0,0,0.100792,0.806883,0
Faiza,Faiza,,85,85,170,85,85,170,2,0.522216,0.542543,0.000625,0.026802,0.026802,8,0.00087,0,0,0,0.107843,0.676457,0
Kacie,Kacie,,105,105,210,105,105,210,2,0.527734,0.552553,0.00095,0.033391,0.033391,2,0.001038,0,0,0,0.109524,0.842562,0
Agus Ahmad,Agus Ahmad,,96,96,192,96,96,192,2,0.525237,0.548048,0.000813,0.03033,0.03033,6,0.000963,0,0,0,0.099561,0.765371,0
Cole,Cole,,96,96,192,96,96,192,2,0.525237,0.548048,0.000822,0.029885,0.029885,8,0.000964,0,0,0,0.09386,0.75437,0
Shan Rao,Shan Rao,,94,94,188,94,94,188,2,0.524685,0.547047,0.000803,0.029222,0.029222,8,0.000948,0,0,0,0.103866,0.737653,0
Sleem Savi,Sleem Savi,,108,108,216,108,108,216,2,0.528571,0.554054,0.001027,0.034079,0.034079,4,0.001064,0,0,0,0.105573,0.859946,0
Elizabeth,Elizabeth,,107,107,214,107,107,214,2,0.528292,0.553554,0.000981,0.033664,0.033664,2,0.001056,0,0,0,0.111444,0.849488,0
Qudsia,Qudsia,,93,93,186,93,93,186,2,0.524409,0.546547,0.00076,0.029359,0.029359,4,0.000937,0,0,0,0.100047,0.740959,0
Abid,Abid,,114,114,228,114,114,228,2,0.530255,0.557057,0.001154,0.035745,0.035745,5,0.001116,0,0,0,0.099053,0.901985,0
Livia,Livia,,100,100,200,100,100,200,2,0.526344,0.55005,0.000904,0.031149,0.031149,8,0.000999,0,0,0,0.098182,0.786189,0
Mesum Ammar,Mesum Ammar,,100,100,200,100,100,200,2,0.526344,0.55005,0.000855,0.03201,0.03201,8,0.000995,0,0,0,0.101414,0.807638,0
Hussain,Hussain,,97,97,194,97,97,194,2,0.525513,0.548549,0.000857,0.03025,0.03025,8,0.000973,0,0,0,0.095361,0.763521,0
Areesha,Areesha,,103,103,206,103,103,206,2,0.527177,0.551552,0.000943,0.032462,0.032462,8,0.001023,0,0,0,0.100324,0.819182,0
Muhammad Arslan,Muhammad Arslan,,104,104,208,104,104,208,2,0.527455,0.552052,0.000979,0.032364,0.032364,1,0.001032,0,0,0,0.098768,0.816905,0
Khizaer Hayat,Khizaer Hayat,,96,96,192,96,96,192,2,0.525237,0.548048,0.000802,0.030515,0.030515,5,0.000962,0,0,0,0.097588,0.770021,0
Muhammad Atif,Muhammad Atif,,103,103,206,103,103,206,2,0.527177,0.551552,0.000953,0.032218,0.032218,1,0.001023,0,0,0,0.100324,0.813155,0
Tehmina,Tehmina,,96,96,192,96,96,192,2,0.525237,0.548048,0.00081,0.030249,0.030249,7,0.000963,0,0,0,0.104386,0.763387,0
Porter Devries  ,Porter Devries  ,,106,106,212,106,106,212,2,0.528013,0.553053,0.001012,0.033072,0.033072,0,0.001049,0,0,0,0.098832,0.834703,0
Mikel Lamberson  ,Mikel Lamberson  ,,89,89,178,89,89,178,2,0.523311,0.544545,0.000721,0.027702,0.027702,4,0.000905,0,0,0,0.092697,0.69929,0
Alton Towell  ,Alton Towell  ,,105,105,210,105,105,210,2,0.527734,0.552553,0.000992,0.032596,0.032596,1,0.001041,0,0,0,0.104945,0.822753,0
Neveh,Neveh,,98,98,196,98,98,196,2,0.525789,0.549049,0.000885,0.030204,0.030204,3,0.000983,0,0,0,0.095729,0.762557,0
Miley,Miley,,98,98,196,98,98,196,2,0.525789,0.549049,0.000845,0.030825,0.030825,2,0.00098,0,0,0,0.103934,0.777977,0
Monica,Monica,,109,109,218,109,109,218,2,0.528851,0.554555,0.001106,0.033568,0.033568,2,0.001076,0,0,0,0.098029,0.847485,0
Robbie,Robbie,,103,103,206,103,103,206,2,0.527177,0.551552,0.00093,0.032495,0.032495,3,0.001022,0,0,0,0.100324,0.81998,0
Faisal Khan,Faisal Khan,,100,100,200,100,100,200,2,0.526344,0.55005,0.000863,0.03174,0.03174,0,0.000996,0,0,0,0.104444,0.800895,0
Archie,Archie,,88,88,176,88,88,176,2,0.523037,0.544044,0.000705,0.027354,0.027354,7,0.000897,0,0,0,0.096134,0.690472,0
Sonny,Sonny,,102,102,204,102,102,204,2,0.526899,0.551051,0.000928,0.031886,0.031886,0,0.001015,0,0,0,0.097263,0.804824,0
Kieran,Kieran,,121,121,242,121,121,242,2,0.532232,0.560561,0.001323,0.037862,0.037862,2,0.001176,0,0,0,0.098898,0.955552,0
Adnan,Adnan,,102,102,204,102,102,204,2,0.526899,0.551051,0.000934,0.031893,0.031893,0,0.001015,0,0,0,0.095127,0.804912,0
Yaqoob,Yaqoob,,87,87,174,87,87,174,2,0.522763,0.543544,0.000707,0.026701,0.026701,7,0.00089,0,0,0,0.094627,0.674111,0
Asghar,Asghar,,124,124,248,124,124,248,2,0.533084,0.562062,0.001359,0.039154,0.039154,2,0.0012,0,0,0,0.098086,0.987963,0
Mohail,Mohail,,88,88,176,88,88,176,2,0.523037,0.544044,0.000683,0.027736,0.027736,0,0.000895,0,0,0,0.09535,0.700036,0
Amir Chatta,Amir Chatta,,91,91,182,91,91,182,2,0.523859,0.545546,0.000741,0.028596,0.028596,4,0.000921,0,0,0,0.102564,0.721639,0
Bradley,Bradley,,109,109,218,109,109,218,2,0.528851,0.554555,0.001079,0.033902,0.033902,4,0.001075,0,0,0,0.092932,0.855648,0
Naveed,Naveed,,93,93,186,93,93,186,2,0.524409,0.546547,0.000783,0.029012,0.029012,1,0.000939,0,0,0,0.098644,0.732297,0
Ricky,Ricky,,107,107,214,107,107,214,2,0.528292,0.553554,0.001008,0.033773,0.033773,0,0.001056,0,0,0,0.104038,0.852237,0
Benedict,Benedict,,110,110,220,110,110,220,2,0.529131,0.555055,0.001083,0.034492,0.034492,5,0.001082,0,0,0,0.097081,0.870408,0
Rehan Khan,Rehan Khan,,117,117,234,117,117,234,2,0.5311,0.558559,0.001219,0.036844,0.036844,4,0.001141,0,0,0,0.097849,0.929774,0
Finn,Finn,,90,90,180,90,90,180,2,0.523585,0.545045,0.000705,0.028413,0.028413,4,0.000912,0,0,0,0.102122,0.717032,0
Nasir Abas,Nasir Abas,,96,96,192,96,96,192,2,0.525237,0.548048,0.000821,0.030006,0.030006,3,0.000964,0,0,0,0.1,0.757317,0
Salman,Salman,,93,93,186,93,93,186,2,0.524409,0.546547,0.000774,0.029039,0.029039,0,0.000939,0,0,0,0.102151,0.733012,0
Kamran,Kamran,,121,121,242,121,121,242,2,0.532232,0.560561,0.001313,0.037836,0.037836,3,0.001176,0,0,0,0.096419,0.954905,0
Geaorge,Geaorge,,106,106,212,106,106,212,2,0.528013,0.553053,0.000996,0.033177,0.033177,4,0.001049,0,0,0,0.106918,0.83731,0
Joyce,Joyce,,99,99,198,99,99,198,2,0.526066,0.54955,0.00087,0.031169,0.031169,0,0.000989,0,0,0,0.100392,0.786633,0
Isla,Isla,,107,107,214,107,107,214,2,0.528292,0.553554,0.001005,0.033509,0.033509,0,0.001057,0,0,0,0.109328,0.845677,0
Irafan Doggal,Irafan Doggal,,110,110,220,110,110,220,2,0.529131,0.555055,0.001091,0.034359,0.034359,5,0.001083,0,0,0,0.097581,0.867222,0
Sienna,Sienna,,97,97,194,97,97,194,2,0.525513,0.548549,0.00083,0.030611,0.030611,0,0.000971,0,0,0,0.099012,0.772642,0
Robert,Robert,,95,95,190,95,95,190,2,0.524961,0.547548,0.000793,0.029911,0.029911,2,0.000955,0,0,0,0.102352,0.754871,0
Jasleem,Jasleem,,95,95,190,95,95,190,2,0.524961,0.547548,0.000793,0.030035,0.030035,2,0.000954,0,0,0,0.097424,0.757927,0
Maryam Salman,Maryam Salman,,98,98,196,98,98,196,2,0.525789,0.549049,0.000825,0.031266,0.031266,1,0.000978,0,0,0,0.109194,0.788886,0
Hector,Hector,,109,109,218,109,109,218,2,0.528851,0.554555,0.001062,0.034086,0.034086,7,0.001074,0,0,0,0.104995,0.860298,0
Tanisha,Tanisha,,86,86,172,86,86,172,2,0.52249,0.543043,0.000641,0.027351,0.027351,0,0.000877,0,0,0,0.101505,0.690194,0
Alicia,Alicia,,94,94,188,94,94,188,2,0.524685,0.547047,0.000809,0.029234,0.029234,0,0.000947,0,0,0,0.09014,0.737944,0
Arooj,Arooj,,106,106,212,106,106,212,2,0.528013,0.553053,0.001007,0.033031,0.033031,4,0.001049,0,0,0,0.101348,0.833718,0
Osama Ch,Osama Ch,,107,107,214,107,107,214,2,0.528292,0.553554,0.001063,0.033042,0.033042,8,0.001059,0,0,0,0.094869,0.83412,0
Hayden,Hayden,,88,88,176,88,88,176,2,0.523037,0.544044,0.000723,0.027219,0.027219,7,0.000898,0,0,0,0.088036,0.687096,0
Hamza Rehman,Hamza Rehman,,90,90,180,90,90,180,2,0.523585,0.545045,0.000759,0.027633,0.027633,7,0.000915,0,0,0,0.088889,0.697653,0
Imam Samudra,Imam Samudra,,98,98,196,98,98,196,2,0.525789,0.549049,0.000836,0.031013,0.031013,3,0.000979,0,0,0,0.105197,0.782657,0
Ayaan,Ayaan,,91,91,182,91,91,182,2,0.523859,0.545546,0.000726,0.028671,0.028671,2,0.000921,0,0,0,0.099145,0.723514,0
Joanne,Joanne,,103,103,206,103,103,206,2,0.527177,0.551552,0.000894,0.032992,0.032992,4,0.00102,0,0,0,0.108129,0.83233,0
Ewan,Ewan,,96,96,192,96,96,192,2,0.525237,0.548048,0.000809,0.030131,0.030131,7,0.000964,0,0,0,0.101535,0.760528,0
Felic,Felic,,103,103,206,103,103,206,2,0.527177,0.551552,0.000955,0.032104,0.032104,0,0.001024,0,0,0,0.10375,0.81042,0
Sebastian,Sebastian,,104,104,208,104,104,208,2,0.527455,0.552052,0.00094,0.032892,0.032892,8,0.00103,0,0,0,0.100822,0.829968,0
Mehboob,Mehboob,,92,92,184,92,92,184,2,0.524134,0.546046,0.000763,0.028806,0.028806,0,0.00093,0,0,0,0.095796,0.727056,0
Eleanor,Eleanor,,110,110,220,110,110,220,2,0.529131,0.555055,0.001064,0.034862,0.034862,2,0.001081,0,0,0,0.100584,0.879566,0
Edward,Edward,,110,110,220,110,110,220,2,0.529131,0.555055,0.001064,0.034553,0.034553,4,0.001082,0,0,0,0.105088,0.872006,0
Abdul Rafey,Abdul Rafey,,120,120,240,120,120,240,2,0.531949,0.56006,0.001266,0.037692,0.037692,0,0.001167,0,0,0,0.103221,0.951141,0
Maximillan,Maximillan,,107,107,214,107,107,214,2,0.528292,0.553554,0.001019,0.033452,0.033452,1,0.001057,0,0,0,0.10633,0.844223,0
Jensen,Jensen,,91,91,182,91,91,182,2,0.523859,0.545546,0.000714,0.028737,0.028737,0,0.00092,0,0,0,0.100366,0.725183,0
Lydia,Lydia,,76,76,152,76,76,152,3,0.519501,0.537871,0.000487,0.024211,0.024211,8,0.000793,0,0,0,0.104211,0.610933,0
Nancy,Nancy,,92,92,184,92,92,184,2,0.524134,0.546046,0.000752,0.028677,0.028677,0,0.00093,0,0,0,0.097707,0.723939,0
Rocco,Rocco,,92,92,184,92,92,184,2,0.524134,0.546046,0.000728,0.029208,0.029208,8,0.000928,0,0,0,0.106068,0.737051,0
Madison,Madison,,102,102,204,102,102,204,2,0.526899,0.551051,0.000918,0.032228,0.032228,7,0.001013,0,0,0,0.09571,0.813281,0
Lucy,Lucy,,112,112,224,112,112,224,2,0.529692,0.556056,0.001098,0.035409,0.035409,3,0.001098,0,0,0,0.102638,0.893507,0
Florence,Florence,,92,92,184,92,92,184,2,0.524134,0.546046,0.000723,0.029361,0.029361,7,0.000928,0,0,0,0.10559,0.740832,0
Anna,Anna,,104,104,208,104,104,208,2,0.527455,0.552052,0.000937,0.032962,0.032962,4,0.00103,0,0,0,0.105863,0.831757,0
Lexi,Lexi,,100,100,200,100,100,200,2,0.526344,0.55005,0.000905,0.031172,0.031172,0,0.000998,0,0,0,0.094747,0.786811,0
Matthew,Matthew,,108,108,216,108,108,216,2,0.528571,0.554054,0.00104,0.033789,0.033789,2,0.001065,0,0,0,0.101592,0.852749,0
Jabir,Jabir,,97,97,194,97,97,194,2,0.525513,0.548549,0.00083,0.030361,0.030361,2,0.000972,0,0,0,0.103522,0.76638,0
Ghulam Sadeeq,Ghulam Sadeeq,,94,94,188,94,94,188,3,0.524409,0.54688,0.000782,0.029457,0.029457,2,0.000947,0,0,0,0.104324,0.743435,0
Rosihin Noor,Rosihin Noor,,89,89,178,89,89,178,2,0.523311,0.544545,0.000697,0.02794,0.02794,2,0.000904,0,0,0,0.097293,0.705172,0
Tamala,Tamala,,101,101,202,101,101,202,2,0.526621,0.550551,0.000904,0.031766,0.031766,3,0.001006,0,0,0,0.097822,0.801643,0
Tasawar,Tasawar,,105,105,210,105,105,210,3,0.527455,0.552386,0.000982,0.032755,0.032755,2,0.00104,0,0,0,0.102564,0.82671,0
Martha,Martha,,91,91,182,91,91,182,2,0.523859,0.545546,0.000734,0.028679,0.028679,8,0.000921,0,0,0,0.094994,0.723786,0
Urwah,Urwah,,115,115,230,115,115,230,2,0.530536,0.557558,0.001209,0.035562,0.035562,0,0.001127,0,0,0,0.097635,0.897607,0
Stefen,Stefen,,113,113,226,113,113,226,2,0.529973,0.556557,0.001155,0.035146,0.035146,4,0.001109,0,0,0,0.098451,0.887082,0
Theodore,Theodore,,89,89,178,89,89,178,2,0.523311,0.544545,0.000703,0.027882,0.027882,0,0.000904,0,0,0,0.104699,0.703711,0
Asifa,Asifa,,105,105,210,105,105,210,2,0.527734,0.552553,0.000963,0.033152,0.033152,6,0.001039,0,0,0,0.102747,0.836573,0
Jude,Jude,,103,103,206,103,103,206,2,0.527177,0.551552,0.000947,0.032307,0.032307,4,0.001023,0,0,0,0.106035,0.815316,0
Huma,Huma,,99,99,198,99,99,198,2,0.526066,0.54955,0.000872,0.031191,0.031191,6,0.000988,0,0,0,0.097918,0.787165,0
Quratulain,Quratulain,,96,96,192,96,96,192,2,0.525237,0.548048,0.000815,0.030049,0.030049,0,0.000964,0,0,0,0.103509,0.758363,0
Shamsha Zain,Shamsha Zain,,103,103,206,103,103,206,2,0.527177,0.551552,0.000944,0.032292,0.032292,2,0.001023,0,0,0,0.098039,0.81497,0
Hibah,Hibah,,97,97,194,97,97,194,2,0.525513,0.548549,0.000812,0.030744,0.030744,0,0.000971,0,0,0,0.100086,0.775797,0
Shayan Ali,Shayan Ali,,97,97,194,97,97,194,2,0.525513,0.548549,0.000839,0.030546,0.030546,7,0.000972,0,0,0,0.098582,0.77092,0
Priya,Priya,,102,102,204,102,102,204,2,0.526899,0.551051,0.00094,0.03184,0.03184,1,0.001015,0,0,0,0.100369,0.803611,0
Rawail,Rawail,,121,121,242,121,121,242,2,0.532232,0.560561,0.001255,0.038508,0.038508,4,0.001173,0,0,0,0.102893,0.971497,0
Uzair,Uzair,,109,109,218,109,109,218,2,0.528851,0.554555,0.001055,0.034185,0.034185,2,0.001074,0,0,0,0.104485,0.862747,0
Apuy,Apuy,,105,105,210,105,105,210,2,0.527734,0.552553,0.000969,0.033288,0.033288,6,0.001038,0,0,0,0.094322,0.839891,0
Illa,Illa,,103,103,206,103,103,206,2,0.527177,0.551552,0.000961,0.031946,0.031946,0,0.001024,0,0,0,0.102798,0.806401,0
Logan,Logan,,85,85,170,85,85,170,3,0.521944,0.542376,0.000639,0.026617,0.026617,7,0.00087,0,0,0,0.102521,0.671885,0
Qudratullah,Qudratullah,,102,102,204,102,102,204,2,0.526899,0.551051,0.00091,0.032147,0.032147,0,0.001014,0,0,0,0.100951,0.811256,0
Anthony,Anthony,,100,100,200,100,100,200,2,0.526344,0.55005,0.000918,0.030942,0.030942,4,0.000999,0,0,0,0.092929,0.781041,0
Caitlin,Caitlin,,100,100,200,100,100,200,2,0.526344,0.55005,0.000881,0.031373,0.031373,8,0.000997,0,0,0,0.100606,0.791733,0
Suzanne Syverson  ,Suzanne Syverson  ,,102,102,204,102,102,204,2,0.526899,0.551051,0.000915,0.032084,0.032084,3,0.001014,0,0,0,0.102504,0.809687,0
Kate Shiver  ,Kate Shiver  ,,83,83,166,83,83,166,2,0.521671,0.541542,0.000613,0.02604,0.02604,8,0.000854,0,0,0,0.103144,0.657254,0
Trisha Allis  ,Trisha Allis  ,,97,97,194,97,97,194,2,0.525513,0.548549,0.000844,0.030354,0.030354,0,0.000972,0,0,0,0.099656,0.766094,0
Del Garlington  ,Del Garlington  ,,90,90,180,90,90,180,2,0.523585,0.545045,0.00073,0.02807,0.02807,3,0.000913,0,0,0,0.098627,0.708547,0
Reginia Rockwell  ,Reginia Rockwell  ,,96,96,192,96,96,192,2,0.525237,0.548048,0.000835,0.029829,0.029829,3,0.000965,0,0,0,0.091447,0.752919,0
Shavonne Bunch  ,Shavonne Bunch  ,,105,105,210,105,105,210,2,0.527734,0.552553,0.000986,0.032881,0.032881,4,0.00104,0,0,0,0.101832,0.829912,0
Bruce Wix  ,Bruce Wix  ,,108,108,216,108,108,216,2,0.528571,0.554054,0.001019,0.03416,0.03416,6,0.001064,0,0,0,0.102111,0.861963,0
Saif Ali,Saif Ali,,94,94,188,94,94,188,2,0.524685,0.547047,0.000793,0.029411,0.029411,5,0.000947,0,0,0,0.09952,0.742269,0
Destor,Destor,,95,95,190,95,95,190,2,0.524961,0.547548,0.000793,0.029982,0.029982,0,0.000954,0,0,0,0.099216,0.756646,0
Zara,Zara,,100,100,200,100,100,200,2,0.526344,0.55005,0.000889,0.031364,0.031364,8,0.000997,0,0,0,0.1,0.791539,0
Saba,Saba,,88,88,176,88,88,176,2,0.523037,0.544044,0.000681,0.027665,0.027665,3,0.000896,0,0,0,0.105799,0.698233,0
Paige,Paige,,112,112,224,112,112,224,2,0.529692,0.556056,0.001079,0.035752,0.035752,6,0.001097,0,0,0,0.104408,0.902074,0
Ahmad Sayid Maulana,Ahmad Sayid Maulana,,95,95,190,95,95,190,2,0.524961,0.547548,0.000791,0.029837,0.029837,3,0.000955,0,0,0,0.103247,0.752966,0
Arslan,Arslan,,115,115,230,115,115,230,2,0.530536,0.557558,0.001195,0.035962,0.035962,7,0.001125,0,0,0,0.095042,0.90759,0
Abdul Basit,Abdul Basit,,102,102,204,102,102,204,2,0.526899,0.551051,0.000924,0.03185,0.03185,6,0.001015,0,0,0,0.106581,0.803913,0
Shazi harry,Shazi harry,,109,109,218,109,109,218,2,0.528851,0.554555,0.001099,0.033661,0.033661,0,0.001076,0,0,0,0.099388,0.849679,0
Ellis,Ellis,,112,112,224,112,112,224,2,0.529692,0.556056,0.001104,0.035272,0.035272,2,0.001098,0,0,0,0.102799,0.890122,0
Asha,Asha,,108,108,216,108,108,216,2,0.528571,0.554054,0.001033,0.033922,0.033922,7,0.001065,0,0,0,0.096227,0.85603,0
Emme,Emme,,105,105,210,105,105,210,2,0.527734,0.552553,0.00094,0.033497,0.033497,4,0.001037,0,0,0,0.104945,0.845148,0
Sanam Butt,Sanam Butt,,112,112,224,112,112,224,2,0.529692,0.556056,0.001134,0.034881,0.034881,8,0.0011,0,0,0,0.096525,0.880361,0
Laura,Laura,,89,89,178,89,89,178,2,0.523311,0.544545,0.00069,0.028148,0.028148,0,0.000903,0,0,0,0.100613,0.710335,0
Omaid,Omaid,,105,105,210,105,105,210,2,0.527734,0.552553,0.000969,0.033182,0.033182,8,0.001039,0,0,0,0.097985,0.8373,0
Arthur,Arthur,,106,106,212,106,106,212,2,0.528013,0.553053,0.001004,0.033271,0.033271,1,0.001048,0,0,0,0.103504,0.839645,0
Usman Kazi,Usman Kazi,,106,106,212,106,106,212,2,0.528013,0.553053,0.001002,0.033202,0.033202,8,0.001049,0,0,0,0.103504,0.838047,0
Rameez,Rameez,,112,112,224,112,112,224,2,0.529692,0.556056,0.001098,0.035624,0.035624,3,0.001097,0,0,0,0.094112,0.898814,0
Tia,Tia,,109,109,218,109,109,218,2,0.528851,0.554555,0.001045,0.034468,0.034468,0,0.001073,0,0,0,0.104995,0.869682,0
Harleu,Harleu,,103,103,206,103,103,206,2,0.527177,0.551552,0.000915,0.032677,0.032677,4,0.001021,0,0,0,0.105464,0.824463,0
Mohammad Ata Farid,Mohammad Ata Farid,,107,107,214,107,107,214,2,0.528292,0.553554,0.00104,0.033235,0.033235,7,0.001058,0,0,0,0.093282,0.838811,0
Shanice,Shanice,,98,98,196,98,98,196,2,0.525789,0.549049,0.000873,0.030524,0.030524,7,0.000981,0,0,0,0.100568,0.770458,0
Qareem,Qareem,,106,106,212,106,106,212,2,0.528013,0.553053,0.000997,0.033302,0.033302,3,0.001048,0,0,0,0.095957,0.840396,0
Miliana,Miliana,,90,90,180,90,90,180,2,0.523585,0.545045,0.000724,0.028126,0.028126,7,0.000913,0,0,0,0.102871,0.709974,0
Saeed,Saeed,,104,104,208,104,104,208,2,0.527455,0.552052,0.000962,0.032615,0.032615,8,0.001031,0,0,0,0.104369,0.823162,0
Christopher,Christopher,,92,92,184,92,92,184,2,0.524134,0.546046,0.000766,0.028632,0.028632,2,0.000931,0,0,0,0.09699,0.722745,0
Bella,Bella,,102,102,204,102,102,204,2,0.526899,0.551051,0.000914,0.032219,0.032219,1,0.001013,0,0,0,0.099981,0.813029,0
Hope,Hope,,94,94,188,94,94,188,2,0.524685,0.547047,0.000783,0.029447,0.029447,2,0.000947,0,0,0,0.099062,0.743222,0
Kashf,Kashf,,103,103,206,103,103,206,2,0.527177,0.551552,0.000927,0.03259,0.03259,1,0.001022,0,0,0,0.112698,0.822346,0
Brian,Brian,,103,103,206,103,103,206,2,0.527177,0.551552,0.000956,0.032188,0.032188,2,0.001024,0,0,0,0.099753,0.812319,0
Mohamed Rais,Mohamed Rais,,101,101,202,101,101,202,2,0.526621,0.550551,0.000892,0.031804,0.031804,7,0.001005,0,0,0,0.10099,0.802608,0
Nusrat Khan,Nusrat Khan,,122,122,244,122,122,244,2,0.532516,0.561061,0.001319,0.038473,0.038473,8,0.001183,0,0,0,0.100528,0.970699,0
Shehbaaz,Shehbaaz,,98,98,196,98,98,196,2,0.525789,0.549049,0.000852,0.030767,0.030767,6,0.00098,0,0,0,0.099306,0.776527,0
Michelle,Michelle,,106,106,212,106,106,212,2,0.528013,0.553053,0.000996,0.033148,0.033148,3,0.001049,0,0,0,0.10009,0.836555,0
Nargis,Nargis,,92,92,184,92,92,184,2,0.524134,0.546046,0.000764,0.02852,0.02852,3,0.000931,0,0,0,0.09699,0.71994,0
Alveena,Alveena,,107,107,214,107,107,214,2,0.528292,0.553554,0.001024,0.03351,0.03351,4,0.001057,0,0,0,0.09769,0.845717,0
Phoebe,Phoebe,,100,100,200,100,100,200,2,0.526344,0.55005,0.000879,0.031506,0.031506,2,0.000997,0,0,0,0.100202,0.795114,0
Holly,Holly,,93,93,186,93,93,186,2,0.524409,0.546547,0.00079,0.02878,0.02878,1,0.000939,0,0,0,0.09841,0.72652,0
Spencer,Spencer,,103,103,206,103,103,206,2,0.527177,0.551552,0.000944,0.032389,0.032389,2,0.001023,0,0,0,0.094613,0.81745,0
Faye,Faye,,99,99,198,99,99,198,2,0.526066,0.54955,0.000863,0.031146,0.031147,8,0.000989,0,0,0,0.103484,0.786002,0
Zubaila,Zubaila,,110,110,220,110,110,220,2,0.529131,0.555055,0.001075,0.034716,0.034716,5,0.001081,0,0,0,0.097748,0.876005,0
Nuala,Nuala,,97,97,194,97,97,194,2,0.525513,0.548549,0.000827,0.030528,0.030528,3,0.000972,0,0,0,0.095361,0.77043,0
Ernie,Ernie,,127,127,254,127,127,254,2,0.533939,0.563564,0.001471,0.039481,0.039481,3,0.001228,0,0,0,0.096113,0.996449,0
Abdul Rauf,Abdul Rauf,,81,81,162,81,81,162,2,0.521127,0.540541,0.000554,0.025869,0.025869,2,0.000835,0,0,0,0.10463,0.652749,0
Fajar,Fajar,,93,93,186,93,93,186,2,0.524409,0.546547,0.000763,0.029226,0.029226,7,0.000938,0,0,0,0.102852,0.737657,0
Courtney,Courtney,,102,102,204,102,102,204,2,0.526899,0.551051,0.000912,0.032093,0.032093,4,0.001014,0,0,0,0.107746,0.809896,0
Daniel,Daniel,,111,111,222,111,111,222,2,0.529412,0.555556,0.001096,0.034726,0.034726,3,0.001091,0,0,0,0.102211,0.876394,0
Omair Hassan,Omair Hassan,,86,86,172,86,86,172,2,0.52249,0.543043,0.000673,0.026638,0.026638,6,0.00088,0,0,0,0.100137,0.672502,0
Kawish,Kawish,,111,111,222,111,111,222,2,0.529412,0.555556,0.001114,0.034668,0.034668,7,0.001091,0,0,0,0.099918,0.87496,0
Isco,Isco,,104,104,208,104,104,208,2,0.527455,0.552052,0.000977,0.03251,0.03251,7,0.001032,0,0,0,0.09354,0.820533,0
Rameesha,Rameesha,,103,103,206,103,103,206,2,0.527177,0.551552,0.000949,0.032353,0.032353,3,0.001023,0,0,0,0.099372,0.816453,0
Rose,Rose,,109,109,218,109,109,218,2,0.528851,0.554555,0.001085,0.033994,0.033994,4,0.001075,0,0,0,0.100408,0.857941,0
Kaiden,Kaiden,,113,113,226,113,113,226,2,0.529973,0.556557,0.001131,0.035532,0.035532,1,0.001107,0,0,0,0.102718,0.896673,0
Ladawn Creason  ,Ladawn Creason  ,,100,100,200,100,100,200,2,0.526344,0.55005,0.000879,0.031524,0.031524,7,0.000997,0,0,0,0.10202,0.795528,0
Season Follmer  ,Season Follmer  ,,101,101,202,101,101,202,3,0.526344,0.550384,0.000914,0.031568,0.031568,6,0.001006,0,0,0,0.099802,0.796727,0
Bobbie Straka  ,Bobbie Straka  ,,101,101,202,101,101,202,2,0.526621,0.550551,0.00093,0.031466,0.031466,3,0.001007,0,0,0,0.100792,0.794169,0
Adela Babst  ,Adela Babst  ,,79,79,158,79,79,158,2,0.520584,0.53954,0.00055,0.024747,0.024747,7,0.00082,0,0,0,0.101915,0.62467,0
Charity Schrecengost  ,Charity Schrecengost  ,,101,101,202,101,101,202,2,0.526621,0.550551,0.000896,0.031766,0.031766,1,0.001005,0,0,0,0.100594,0.801678,0
Hania,Hania,,86,86,172,86,86,172,2,0.52249,0.543043,0.000672,0.026782,0.026782,8,0.00088,0,0,0,0.093023,0.676046,0
Jared,Jared,,108,108,216,108,108,216,2,0.528571,0.554054,0.001,0.034452,0.034452,4,0.001063,0,0,0,0.102977,0.869218,0
Jhonny,Jhonny,,94,94,188,94,94,188,2,0.524685,0.547047,0.000784,0.029488,0.029488,8,0.000947,0,0,0,0.09952,0.744169,0
Javeed Qazi,Javeed Qazi,,94,94,188,94,94,188,2,0.524685,0.547047,0.000805,0.029141,0.029141,6,0.000948,0,0,0,0.092427,0.735599,0
Elsie,Elsie,,107,107,214,107,107,214,2,0.528292,0.553554,0.001028,0.033554,0.033554,8,0.001057,0,0,0,0.099453,0.846739,0
Madeleine,Madeleine,,94,94,188,94,94,188,2,0.524685,0.547047,0.000792,0.029269,0.029269,8,0.000947,0,0,0,0.102951,0.738845,0
Abby,Abby,,88,88,176,88,88,176,2,0.523037,0.544044,0.000681,0.027761,0.027761,7,0.000895,0,0,0,0.096656,0.700597,0
Sofia,Sofia,,106,106,212,106,106,212,2,0.528013,0.553053,0.000986,0.03341,0.03341,3,0.001048,0,0,0,0.106379,0.843148,0
Abdul Rafeh,Abdul Rafeh,,118,118,236,118,118,236,2,0.531383,0.559059,0.001267,0.036543,0.036543,0,0.001152,0,0,0,0.101985,0.922349,0
Syed Bilal,Syed Bilal,,108,108,216,108,108,216,2,0.528571,0.554054,0.001019,0.034347,0.034347,8,0.001063,0,0,0,0.1009,0.866621,0
Rowan,Rowan,,109,109,218,109,109,218,2,0.528851,0.554555,0.001065,0.034101,0.034101,7,0.001074,0,0,0,0.104145,0.860713,0
Sajjad Sikandar,Sajjad Sikandar,,98,98,196,98,98,196,2,0.525789,0.549049,0.000832,0.030895,0.030895,7,0.00098,0,0,0,0.107721,0.779719,0
Joni Achmad Fauzan,Joni Achmad Fauzan,,94,94,188,94,94,188,2,0.524685,0.547047,0.00078,0.029677,0.029677,7,0.000946,0,0,0,0.097003,0.748872,0
Abdullah Khan,Abdullah Khan,,124,124,248,124,124,248,2,0.533084,0.562062,0.001358,0.039228,0.039228,3,0.001199,0,0,0,0.098872,0.989752,0
Miolly,Miolly,,94,94,188,94,94,188,2,0.524685,0.547047,0.000778,0.029381,0.029381,7,0.000947,0,0,0,0.102494,0.741554,0
Harry,Harry,,100,100,200,100,100,200,2,0.526344,0.55005,0.000892,0.031509,0.031509,7,0.000997,0,0,0,0.093333,0.795197,0
Lyra,Lyra,,112,112,224,112,112,224,2,0.529692,0.556056,0.001112,0.035086,0.035086,3,0.001099,0,0,0,0.111004,0.885463,0
Angel,Angel,,106,106,212,106,106,212,2,0.528013,0.553053,0.001014,0.033124,0.033124,5,0.001049,0,0,0,0.092363,0.835955,0
Tania,Tania,,109,109,218,109,109,218,2,0.528851,0.554555,0.001025,0.034537,0.034537,8,0.001072,0,0,0,0.108563,0.871408,0
Malik Touqeer,Malik Touqeer,,88,88,176,88,88,176,2,0.523037,0.544044,0.000684,0.027776,0.027776,4,0.000895,0,0,0,0.095611,0.701047,0
Nikita,Nikita,,104,104,208,104,104,208,2,0.527455,0.552052,0.00098,0.032275,0.032275,8,0.001033,0,0,0,0.101942,0.814723,0
Kayden,Kayden,,114,114,228,114,114,228,2,0.530255,0.557057,0.001131,0.036172,0.036172,1,0.001115,0,0,0,0.101382,0.912699,0
Asher,Asher,,110,110,220,110,110,220,2,0.529131,0.555055,0.001111,0.034073,0.034073,7,0.001084,0,0,0,0.101751,0.859995,0
Maya,Maya,,99,99,198,99,99,198,2,0.526066,0.54955,0.000846,0.031335,0.031335,4,0.000988,0,0,0,0.103278,0.790747,0
Reece,Reece,,107,107,214,107,107,214,2,0.528292,0.553554,0.000981,0.03427,0.03427,7,0.001054,0,0,0,0.098748,0.864602,0
Charlotte,Charlotte,,107,107,214,107,107,214,2,0.528292,0.553554,0.000997,0.033886,0.033886,4,0.001055,0,0,0,0.100335,0.855063,0
Sadie,Sadie,,80,80,160,80,80,160,2,0.520855,0.54004,0.000577,0.024774,0.024774,7,0.000829,0,0,0,0.1,0.625428,0
Imad,Imad,,118,118,236,118,118,236,2,0.531383,0.559059,0.001224,0.037305,0.037305,1,0.001149,0,0,0,0.101115,0.941237,0
Saleem Hassan,Saleem Hassan,,101,101,202,101,101,202,2,0.526621,0.550551,0.000886,0.031998,0.031998,7,0.001004,0,0,0,0.10099,0.807408,0
Freya,Freya,,83,83,166,83,83,166,3,0.521127,0.541208,0.000599,0.026193,0.026193,4,0.000853,0,0,0,0.106377,0.66106,0
Marley,Marley,,98,98,196,98,98,196,2,0.525789,0.549049,0.000866,0.030465,0.030465,2,0.000982,0,0,0,0.097833,0.76888,0
Roberto,Roberto,,96,96,192,96,96,192,2,0.525237,0.548048,0.000802,0.030253,0.030253,8,0.000963,0,0,0,0.103947,0.76353,0
Nathaniel,Nathaniel,,96,96,192,96,96,192,2,0.525237,0.548048,0.000819,0.030104,0.030104,0,0.000963,0,0,0,0.099781,0.759767,0
Akmal Khan,Akmal Khan,,98,98,196,98,98,196,2,0.525789,0.549049,0.000894,0.030082,0.030082,7,0.000983,0,0,0,0.093835,0.759538,0
Umar Wayan,Umar Wayan,,107,107,214,107,107,214,2,0.528292,0.553554,0.000989,0.033941,0.033941,5,0.001055,0,0,0,0.102098,0.8565,0
Cameron,Cameron,,102,102,204,102,102,204,2,0.526899,0.551051,0.000953,0.031787,0.031787,6,0.001016,0,0,0,0.098622,0.802285,0
Savannah,Savannah,,101,101,202,101,101,202,2,0.526621,0.550551,0.00091,0.031463,0.031463,0,0.001007,0,0,0,0.101584,0.794183,0
Teddy,Teddy,,95,95,190,95,95,190,2,0.524961,0.547548,0.000825,0.029539,0.029539,3,0.000956,0,0,0,0.090929,0.745679,0
Francessca,Francessca,,100,100,200,100,100,200,2,0.526344,0.55005,0.000881,0.031533,0.031533,8,0.000997,0,0,0,0.098586,0.795833,0
Rebbeca,Rebbeca,,93,93,186,93,93,186,2,0.524409,0.546547,0.000753,0.02937,0.02937,7,0.000938,0,0,0,0.103319,0.741161,0
Achmad Hasan,Achmad Hasan,,81,81,162,81,81,162,2,0.521127,0.540541,0.000591,0.025052,0.025052,7,0.000838,0,0,0,0.097531,0.632478,0
Emilio,Emilio,,86,86,172,86,86,172,2,0.52249,0.543043,0.000635,0.0273,0.0273,2,0.000877,0,0,0,0.105882,0.688871,0
Usman bin Sef,Usman bin Sef,,105,105,210,105,105,210,2,0.527734,0.552553,0.000983,0.032926,0.032926,0,0.00104,0,0,0,0.097985,0.831007,0
Mohsin,Mohsin,,106,106,212,106,106,212,2,0.528013,0.553053,0.001031,0.032812,0.032812,8,0.00105,0,0,0,0.096496,0.828195,0
Betsy,Betsy,,95,95,190,95,95,190,2,0.524961,0.547548,0.0008,0.029628,0.029628,7,0.000956,0,0,0,0.103471,0.747911,0
Abbie,Abbie,,96,96,192,96,96,192,2,0.525237,0.548048,0.000843,0.029776,0.029776,8,0.000965,0,0,0,0.095833,0.751606,0
Caleb,Caleb,,105,105,210,105,105,210,2,0.527734,0.552553,0.001007,0.032588,0.032588,7,0.001041,0,0,0,0.097619,0.822524,0
Chirag Latif,Chirag Latif,,108,108,216,108,108,216,2,0.528571,0.554054,0.001016,0.033967,0.033967,8,0.001065,0,0,0,0.108169,0.857186,0
Lacie,Lacie,,107,107,214,107,107,214,2,0.528292,0.553554,0.001034,0.033229,0.033229,2,0.001058,0,0,0,0.10633,0.838759,0
Ranjeet Punshi,Ranjeet Punshi,,121,121,242,121,121,242,2,0.532232,0.560561,0.001323,0.037767,0.037767,2,0.001176,0,0,0,0.098347,0.953103,0
Sarah Batool,Sarah Batool,,107,107,214,107,107,214,2,0.528292,0.553554,0.00101,0.033674,0.033674,8,0.001056,0,0,0,0.097337,0.84985,0
Muhammad Irfan,Muhammad Irfan,,108,108,216,108,108,216,2,0.528571,0.554054,0.001044,0.033791,0.033791,0,0.001066,0,0,0,0.095881,0.85282,0
Elsie Mealing  ,Elsie Mealing  ,,106,106,212,106,106,212,2,0.528013,0.553053,0.00102,0.032939,0.032939,2,0.00105,0,0,0,0.099551,0.831532,0
Alisia Allison  ,Alisia Allison  ,,111,111,222,111,111,222,2,0.529412,0.555556,0.001118,0.034626,0.034626,3,0.001092,0,0,0,0.092711,0.873906,0
Robyn,Robyn,,91,91,182,91,91,182,2,0.523859,0.545546,0.000777,0.0278,0.0278,7,0.000925,0,0,0,0.095726,0.701983,0
Mohamed Saifuddin,Mohamed Saifuddin,,93,93,186,93,93,186,2,0.524409,0.546547,0.000733,0.029711,0.029711,5,0.000936,0,0,0,0.101449,0.749734,0
Suramto,Suramto,,92,92,184,92,92,184,2,0.524134,0.546046,0.000767,0.028659,0.028659,0,0.00093,0,0,0,0.098184,0.723388,0
Khurrum Shehzad,Khurrum Shehzad,,101,101,202,101,101,202,2,0.526621,0.550551,0.0009,0.031732,0.031732,2,0.001006,0,0,0,0.10396,0.80086,0
Liberty,Liberty,,105,105,210,105,105,210,2,0.527734,0.552553,0.000963,0.033128,0.033128,6,0.001039,0,0,0,0.108425,0.835999,0
Jax,Jax,,98,98,196,98,98,196,2,0.525789,0.549049,0.000845,0.030845,0.030845,6,0.00098,0,0,0,0.102672,0.778309,0
Ahsan Butt,Ahsan Butt,,112,112,224,112,112,224,2,0.529692,0.556056,0.001076,0.035641,0.035641,4,0.001097,0,0,0,0.102477,0.899332,0
Morgab,Morgab,,108,108,216,108,108,216,2,0.528571,0.554054,0.001048,0.033779,0.033779,2,0.001066,0,0,0,0.099515,0.852477,0
Poppy,Poppy,,101,101,202,101,101,202,2,0.526621,0.550551,0.000896,0.031764,0.031764,5,0.001006,0,0,0,0.105743,0.801719,0
Eden,Eden,,85,85,170,85,85,170,2,0.522216,0.542543,0.000632,0.026749,0.026749,1,0.00087,0,0,0,0.10028,0.675083,0
Aceng Kurnia,Aceng Kurnia,,99,99,198,99,99,198,2,0.526066,0.54955,0.000886,0.030886,0.030886,4,0.00099,0,0,0,0.091115,0.779581,0
Harun,Harun,,117,117,234,117,117,234,2,0.5311,0.558559,0.001237,0.036593,0.036593,5,0.001142,0,0,0,0.094164,0.923448,0
Azad Bhutto,Azad Bhutto,,95,95,190,95,95,190,2,0.524961,0.547548,0.000802,0.029775,0.029775,4,0.000955,0,0,0,0.103919,0.7515,0
Guriya,Guriya,,102,102,204,102,102,204,2,0.526899,0.551051,0.000922,0.032095,0.032095,0,0.001014,0,0,0,0.102116,0.809998,0
Morata,Morata,,100,100,200,100,100,200,2,0.526344,0.55005,0.000884,0.031452,0.031452,4,0.000997,0,0,0,0.097778,0.793755,0
Sobiya,Sobiya,,99,99,198,99,99,198,2,0.526066,0.54955,0.000886,0.030853,0.030853,8,0.00099,0,0,0,0.102453,0.778782,0
Shannon,Shannon,,106,106,212,106,106,212,2,0.528013,0.553053,0.000963,0.033643,0.033643,5,0.001047,0,0,0,0.102066,0.848815,0
Muhammad Usama,Muhammad Usama,,97,97,194,97,97,194,2,0.525513,0.548549,0.000833,0.03053,0.03053,0,0.000972,0,0,0,0.092354,0.770471,0
Kyle,Kyle,,101,101,202,101,101,202,2,0.526621,0.550551,0.000922,0.031422,0.031422,2,0.001007,0,0,0,0.095248,0.793119,0
Aziz ur Rehman,Aziz ur Rehman,,90,90,180,90,90,180,2,0.523585,0.545045,0.0007,0.028422,0.028422,0,0.000912,0,0,0,0.107865,0.717287,0
Ali Dogar,Ali Dogar,,102,102,204,102,102,204,2,0.526899,0.551051,0.00095,0.031649,0.031649,8,0.001016,0,0,0,0.095515,0.798835,0
Iris,Iris,,103,103,206,103,103,206,2,0.527177,0.551552,0.000957,0.03195,0.03195,2,0.001025,0,0,0,0.102227,0.806547,0
Subur Sugiarto,Subur Sugiarto,,98,98,196,98,98,196,2,0.525789,0.549049,0.000884,0.030379,0.030379,2,0.000982,0,0,0,0.091311,0.766989,0
Abu Bakar Ba'asyir,Abu Bakar Ba'asyir,,92,92,184,92,92,184,2,0.524134,0.546046,0.000758,0.028736,0.028736,4,0.00093,0,0,0,0.098184,0.725261,0
Natalie,Natalie,,108,108,216,108,108,216,2,0.528571,0.554054,0.001031,0.033906,0.033906,4,0.001065,0,0,0,0.099515,0.855698,0
Hannah,Hannah,,92,92,184,92,92,184,2,0.524134,0.546046,0.000759,0.028872,0.028872,7,0.00093,0,0,0,0.096512,0.728738,0
Haider Umar,Haider Umar,,105,105,210,105,105,210,2,0.527734,0.552553,0.000995,0.032839,0.032839,7,0.00104,0,0,0,0.095788,0.828792,0
Rehmat Khan,Rehmat Khan,,103,103,206,103,103,206,2,0.527177,0.551552,0.000947,0.032355,0.032355,5,0.001023,0,0,0,0.095755,0.81646,0
Pollard,Pollard,,89,89,178,89,89,178,2,0.523311,0.544545,0.00071,0.027648,0.027648,2,0.000906,0,0,0,0.108018,0.697908,0
Shahzada Asad,Shahzada Asad,,100,100,200,100,100,200,2,0.526344,0.55005,0.00088,0.031461,0.031461,7,0.000997,0,0,0,0.095758,0.793904,0
Saleem Ahmed,Saleem Ahmed,,93,93,186,93,93,186,2,0.524409,0.546547,0.000753,0.029369,0.029369,2,0.000937,0,0,0,0.102151,0.741133,0
Faizan,Faizan,,116,116,232,116,116,232,2,0.530818,0.558058,0.001184,0.036713,0.036713,1,0.001132,0,0,0,0.102849,0.92631,0
Muhammad Arif,Muhammad Arif,,119,119,238,119,119,238,2,0.531666,0.55956,0.001321,0.036605,0.036605,4,0.001162,0,0,0,0.099843,0.924118,0
Max,Max,,99,99,198,99,99,198,2,0.526066,0.54955,0.000862,0.031209,0.031209,7,0.000988,0,0,0,0.096269,0.787602,0
Noki Dada,Noki Dada,,100,100,200,100,100,200,2,0.526344,0.55005,0.000882,0.031591,0.031591,6,0.000997,0,0,0,0.099394,0.797154,0
Munfiatun,Munfiatun,,90,90,180,90,90,180,2,0.523585,0.545045,0.000715,0.028216,0.028216,7,0.000913,0,0,0,0.10412,0.712248,0
Saturna,Saturna,,98,98,196,98,98,196,2,0.525789,0.549049,0.000839,0.030893,0.030893,4,0.00098,0,0,0,0.100568,0.7796,0
Seren,Seren,,99,99,198,99,99,198,2,0.526066,0.54955,0.000873,0.031086,0.031086,3,0.000989,0,0,0,0.093383,0.784536,0
Alliya,Alliya,,84,84,168,84,84,168,2,0.521944,0.542042,0.000632,0.026174,0.026174,3,0.000863,0,0,0,0.094378,0.660723,0
Anaya,Anaya,,111,111,222,111,111,222,2,0.529412,0.555556,0.001104,0.034604,0.034604,8,0.001092,0,0,0,0.100246,0.873294,0
Michiko,Michiko,,113,113,226,113,113,226,2,0.529973,0.556557,0.001153,0.035157,0.035157,4,0.001109,0,0,0,0.10177,0.887305,0
Ayesha,Ayesha,,98,98,196,98,98,196,3,0.525513,0.548882,0.000874,0.030427,0.030427,3,0.000982,0,0,0,0.098675,0.768195,0
Syed Muhammad Shah,Syed Muhammad Shah,,102,102,204,102,102,204,2,0.526899,0.551051,0.000934,0.032109,0.032109,2,0.001014,0,0,0,0.09571,0.810251,0
Maise,Maise,,100,100,200,100,100,200,2,0.526344,0.55005,0.000905,0.031151,0.031151,4,0.000998,0,0,0,0.096162,0.786209,0
Haris,Haris,,83,83,166,83,83,166,3,0.521399,0.541375,0.000616,0.025955,0.025955,3,0.000854,0,0,0,0.09521,0.655128,0
Muhammad Rasheed,Muhammad Rasheed,,104,104,208,104,104,208,2,0.527455,0.552052,0.000969,0.032693,0.032693,8,0.001031,0,0,0,0.101008,0.825071,0
Aaron,Aaron,,103,103,206,103,103,206,2,0.527177,0.551552,0.000957,0.032085,0.032085,0,0.001024,0,0,0,0.097468,0.809895,0
Rabi Akbar,Rabi Akbar,,94,94,188,94,94,188,2,0.524685,0.547047,0.000797,0.029347,0.029347,2,0.000947,0,0,0,0.094944,0.740869,0
Venice Liller  ,Venice Liller  ,,119,119,238,119,119,238,2,0.531666,0.55956,0.001303,0.036912,0.036912,0,0.00116,0,0,0,0.091725,0.931699,0
Abubakar Shaikh,Abubakar Shaikh,,100,100,200,100,100,200,2,0.526344,0.55005,0.000876,0.031631,0.031631,4,0.000996,0,0,0,0.101414,0.79826,0
Muhammad Rehan,Muhammad Rehan,,94,94,188,94,94,188,2,0.524685,0.547047,0.000763,0.029675,0.029675,0,0.000946,0,0,0,0.098147,0.748917,0
Syed Kashif,Syed Kashif,,93,93,186,93,93,186,2,0.524409,0.546547,0.000739,0.029504,0.029504,8,0.000937,0,0,0,0.111501,0.744524,0
Alice,Alice,,83,83,166,83,83,166,2,0.521671,0.541542,0.000592,0.026313,0.026313,6,0.000852,0,0,0,0.096386,0.664021,0
Blanka,Blanka,,111,111,222,111,111,222,2,0.529412,0.555556,0.0011,0.03474,0.03474,6,0.001091,0,0,0,0.098608,0.876811,0
Annie,Annie,,92,92,184,92,92,184,2,0.524134,0.546046,0.000742,0.028986,0.028986,2,0.000929,0,0,0,0.095557,0.731502,0
Zoha,Zoha,,93,93,186,93,93,186,2,0.524409,0.546547,0.000759,0.029335,0.029335,2,0.000937,0,0,0,0.099813,0.740327,0
Ayub,Ayub,,92,92,184,92,92,184,2,0.524134,0.546046,0.000773,0.028629,0.028629,5,0.000931,0,0,0,0.100812,0.722701,0
Saim Shah Hamdani,Saim Shah Hamdani,,93,93,186,93,93,186,2,0.524409,0.546547,0.000771,0.029093,0.029093,8,0.000939,0,0,0,0.097709,0.734323,0
Kami Khokar,Kami Khokar,,96,96,192,96,96,192,2,0.525237,0.548048,0.000818,0.030197,0.030197,8,0.000963,0,0,0,0.099781,0.762167,0
Douglas,Douglas,,108,108,216,108,108,216,2,0.528571,0.554054,0.001027,0.033963,0.033963,5,0.001065,0,0,0,0.099169,0.857085,0
Bilwal,Bilwal,,112,112,224,112,112,224,2,0.529692,0.556056,0.001075,0.035847,0.035847,3,0.001096,0,0,0,0.097169,0.904417,0
Jenson,Jenson,,110,110,220,110,110,220,2,0.529131,0.555055,0.001051,0.034973,0.034973,2,0.00108,0,0,0,0.102585,0.882411,0
Jordi Alba,Jordi Alba,,96,96,192,96,96,192,3,0.524961,0.547881,0.000863,0.029512,0.029512,2,0.000966,0,0,0,0.100219,0.745064,0
Alexis,Alexis,,105,105,210,105,105,210,2,0.527734,0.552553,0.000978,0.033028,0.033028,0,0.00104,0,0,0,0.096703,0.833507,0
Busquets,Busquets,,113,113,226,113,113,226,2,0.529973,0.556557,0.001125,0.035459,0.035459,8,0.001107,0,0,0,0.104614,0.894913,0
Jenna,Jenna,,99,99,198,99,99,198,2,0.526066,0.54955,0.000869,0.031119,0.031119,5,0.000989,0,0,0,0.096063,0.785323,0
Jaazib,Jaazib,,101,101,202,101,101,202,2,0.526621,0.550551,0.000887,0.031959,0.031959,3,0.001005,0,0,0,0.107525,0.80645,0
Mehboob Sain,Mehboob Sain,,95,95,190,95,95,190,2,0.524961,0.547548,0.000763,0.030338,0.030338,5,0.000953,0,0,0,0.102128,0.76551,0
Janu ki Jaan,Janu ki Jaan,,79,79,158,79,79,158,2,0.520584,0.53954,0.000554,0.024921,0.024921,7,0.000819,0,0,0,0.096722,0.628941,0
Fawad,Fawad,,110,110,220,110,110,220,2,0.529131,0.555055,0.001099,0.034338,0.034338,2,0.001083,0,0,0,0.092577,0.866664,0
Khateeb Ali,Khateeb Ali,,89,89,178,89,89,178,2,0.523311,0.544545,0.000697,0.028026,0.028026,3,0.000904,0,0,0,0.099847,0.707314,0
Haris Mujeeb,Haris Mujeeb,,89,89,178,89,89,178,2,0.523311,0.544545,0.000693,0.028148,0.028148,3,0.000903,0,0,0,0.101379,0.710341,0
Aneel,Aneel,,110,110,220,110,110,220,2,0.529131,0.555055,0.001082,0.034453,0.034453,4,0.001082,0,0,0,0.098249,0.869509,0
Muhammad Khan,Muhammad Khan,,80,80,160,80,80,160,2,0.520855,0.54004,0.000559,0.025119,0.025119,3,0.000828,0,0,0,0.106013,0.63398,0
Violet,Violet,,91,91,182,91,91,182,2,0.523859,0.545546,0.000739,0.02844,0.02844,8,0.000922,0,0,0,0.101343,0.717843,0
Mabel,Mabel,,81,81,162,81,81,162,2,0.521127,0.540541,0.000581,0.025445,0.025445,3,0.000836,0,0,0,0.104012,0.642188,0
Aquib,Aquib,,96,96,192,96,96,192,2,0.525237,0.548048,0.000805,0.030299,0.030299,2,0.000963,0,0,0,0.104825,0.764684,0
Muhammad Tayyab,Muhammad Tayyab,,96,96,192,96,96,192,2,0.525237,0.548048,0.000856,0.029584,0.029584,1,0.000966,0,0,0,0.093202,0.746851,0
Rosie,Rosie,,102,102,204,102,102,204,2,0.526899,0.551051,0.000905,0.03225,0.03225,8,0.001013,0,0,0,0.103863,0.813843,0
Bushra,Bushra,,100,100,200,100,100,200,2,0.526344,0.55005,0.000857,0.031841,0.031841,5,0.000995,0,0,0,0.103636,0.803476,0
Azam Rumi,Azam Rumi,,107,107,214,107,107,214,2,0.528292,0.553554,0.001031,0.033377,0.033377,5,0.001057,0,0,0,0.095574,0.842366,0
Ella,Ella,,100,100,200,100,100,200,2,0.526344,0.55005,0.000898,0.031218,0.031218,8,0.000998,0,0,0,0.101616,0.787954,0
Pearl,Pearl,,103,103,206,103,103,206,2,0.527177,0.551552,0.000918,0.032608,0.032608,5,0.001021,0,0,0,0.097658,0.822891,0
Ashraf,Ashraf,,107,107,214,107,107,214,2,0.528292,0.553554,0.001043,0.033196,0.033196,5,0.001058,0,0,0,0.096985,0.837993,0
Alberto,Alberto,,103,103,206,103,103,206,2,0.527177,0.551552,0.000945,0.032444,0.032444,7,0.001022,0,0,0,0.098039,0.818849,0
Abdul Salam Khan,Abdul Salam Khan,,107,107,214,107,107,214,2,0.528292,0.553554,0.001016,0.033499,0.033499,7,0.001057,0,0,0,0.097337,0.845414,0
Isaac,Isaac,,97,97,194,97,97,194,2,0.525513,0.548549,0.000873,0.029888,0.029888,8,0.000974,0,0,0,0.093428,0.754549,0
Sardar Aquib,Sardar Aquib,,84,84,168,84,84,168,2,0.521944,0.542042,0.000632,0.026216,0.026216,1,0.000863,0,0,0,0.102697,0.661743,0
Corey,Corey,,109,109,218,109,109,218,2,0.528851,0.554555,0.001068,0.034223,0.034223,2,0.001074,0,0,0,0.093782,0.863652,0
Mollie,Mollie,,88,88,176,88,88,176,2,0.523037,0.544044,0.000693,0.027493,0.027493,0,0.000896,0,0,0,0.099007,0.693942,0
Indiana Jones,Indiana Jones,,97,97,194,97,97,194,2,0.525513,0.548549,0.000807,0.030719,0.030719,6,0.000971,0,0,0,0.111469,0.775153,0
Khubain Ahsan,Khubain Ahsan,,108,108,216,108,108,216,2,0.528571,0.554054,0.001029,0.033928,0.033928,2,0.001065,0,0,0,0.098477,0.856153,0
Mukhtar Ahmed,Mukhtar Ahmed,,104,104,208,104,104,208,2,0.527455,0.552052,0.000952,0.032663,0.032663,7,0.001031,0,0,0,0.102689,0.824254,0
Nabeel Ahmed,Nabeel Ahmed,,82,82,164,82,82,164,2,0.521399,0.541041,0.000581,0.025843,0.025843,2,0.000844,0,0,0,0.107498,0.652297,0
Hence Malewa,Hence Malewa,,108,108,216,108,108,216,2,0.528571,0.554054,0.001027,0.034005,0.034005,3,0.001065,0,0,0,0.098823,0.858049,0
Malik Tayyab,Malik Tayyab,,109,109,218,109,109,218,2,0.528851,0.554555,0.001065,0.034037,0.034037,7,0.001074,0,0,0,0.095481,0.858948,0
Sameed Shahzad,Sameed Shahzad,,105,105,210,105,105,210,2,0.527734,0.552553,0.000961,0.033167,0.033167,1,0.001039,0,0,0,0.099267,0.836947,0
Amir,Amir,,113,113,226,113,113,226,2,0.529973,0.556557,0.001152,0.035442,0.035442,8,0.001108,0,0,0,0.097345,0.894375,0
Alexa,Alexa,,98,98,196,98,98,196,2,0.525789,0.549049,0.00086,0.030582,0.030581,8,0.000982,0,0,0,0.104566,0.771888,0
Asif Khan Baloch,Asif Khan Baloch,,102,102,204,102,102,204,2,0.526899,0.551051,0.000937,0.031985,0.031985,7,0.001014,0,0,0,0.097845,0.80722,0
Mohsin Khan,Mohsin Khan,,112,112,224,112,112,224,2,0.529692,0.556056,0.001119,0.035161,0.035161,2,0.001099,0,0,0,0.100225,0.887285,0
Sundas,Sundas,,104,104,208,104,104,208,2,0.527455,0.552052,0.000977,0.032464,0.032464,8,0.001032,0,0,0,0.097647,0.819357,0
Laila,Laila,,95,95,190,95,95,190,2,0.524961,0.547548,0.000803,0.029748,0.029748,4,0.000955,0,0,0,0.099888,0.750846,0
Summer,Summer,,107,107,214,107,107,214,2,0.528292,0.553554,0.001015,0.033705,0.033705,8,0.001056,0,0,0,0.093634,0.850557,0
Taylor,Taylor,,92,92,184,92,92,184,2,0.524134,0.546046,0.000755,0.0286,0.0286,4,0.000931,0,0,0,0.108935,0.72191,0
Fatima,Fatima,,101,101,202,101,101,202,2,0.526621,0.550551,0.000941,0.031254,0.031254,2,0.001008,0,0,0,0.099604,0.788887,0
Dililah,Dililah,,100,100,200,100,100,200,2,0.526344,0.55005,0.000886,0.031317,0.031317,7,0.000998,0,0,0,0.10303,0.790383,0
Sana Saleem Awan,Sana Saleem Awan,,97,97,194,97,97,194,2,0.525513,0.548549,0.000863,0.030038,0.030038,4,0.000974,0,0,0,0.093643,0.758245,0
Christine,Christine,,106,106,212,106,106,212,2,0.528013,0.553053,0.000993,0.033417,0.033417,2,0.001048,0,0,0,0.101527,0.843291,0
Ali Awan,Ali Awan,,98,98,196,98,98,196,2,0.525789,0.549049,0.000843,0.030915,0.030915,1,0.00098,0,0,0,0.100989,0.78006,0
Saima,Saima,,88,88,176,88,88,176,3,0.522763,0.543877,0.000684,0.027616,0.027616,8,0.000896,0,0,0,0.096917,0.697044,0
Aleisha,Aleisha,,64,64,128,64,64,128,2,0.516546,0.532032,0.000368,0.02008,0.02008,2,0.000692,0,0,0,0.100694,0.506933,0
Louisa,Louisa,,101,101,202,101,101,202,2,0.526621,0.550551,0.000885,0.032096,0.032096,0,0.001004,0,0,0,0.106733,0.809862,0
Umtiti,Umtiti,,125,125,250,125,125,250,2,0.533369,0.562563,0.001405,0.039168,0.039168,8,0.001209,0,0,0,0.095355,0.988515,0
Antony,Antony,,95,95,190,95,95,190,2,0.524961,0.547548,0.00083,0.029361,0.029361,1,0.000957,0,0,0,0.095633,0.741212,0
Sajid Khan,Sajid Khan,,97,97,194,97,97,194,2,0.525513,0.548549,0.000809,0.030828,0.030828,8,0.00097,0,0,0,0.103308,0.777933,0
Aakash,Aakash,,115,115,230,115,115,230,2,0.530536,0.557558,0.001164,0.036325,0.036325,3,0.001124,0,0,0,0.100686,0.916609,0
Rafferty,Rafferty,,101,101,202,101,101,202,2,0.526621,0.550551,0.00092,0.031476,0.031476,0,0.001007,0,0,0,0.102376,0.794518,0
Zahid,Zahid,,108,108,216,108,108,216,2,0.528571,0.554054,0.001018,0.034172,0.034172,8,0.001064,0,0,0,0.104534,0.862325,0
Trump,Trump,,109,109,218,109,109,218,2,0.528851,0.554555,0.001073,0.034076,0.034076,2,0.001074,0,0,0,0.098369,0.860027,0
Hamza Mehar,Hamza Mehar,,95,95,190,95,95,190,2,0.524961,0.547548,0.0008,0.029873,0.029873,5,0.000955,0,0,0,0.09832,0.75391,0
Syed Tafseer Abbass,Syed Tafseer Abbass,,95,95,190,95,95,190,2,0.524961,0.547548,0.000795,0.029863,0.029863,6,0.000955,0,0,0,0.103471,0.753652,0
Neur,Neur,,114,114,228,114,114,228,2,0.530255,0.557057,0.00117,0.035538,0.035538,8,0.001117,0,0,0,0.102469,0.896979,0
Alistar,Alistar,,107,107,214,107,107,214,2,0.528292,0.553554,0.000999,0.033885,0.033885,4,0.001056,0,0,0,0.100335,0.855137,0
Farah Samad,Farah Samad,,110,110,220,110,110,220,2,0.529131,0.555055,0.001076,0.034693,0.034693,2,0.001082,0,0,0,0.098582,0.875492,0
Brianna,Brianna,,95,95,190,95,95,190,2,0.524961,0.547548,0.00079,0.0298,0.0298,4,0.000955,0,0,0,0.103695,0.752063,0
Armaan Jutt,Armaan Jutt,,110,110,220,110,110,220,2,0.529131,0.555055,0.001102,0.034174,0.034174,0,0.001084,0,0,0,0.095246,0.86247,0
Chopra,Chopra,,93,93,186,93,93,186,2,0.524409,0.546547,0.000774,0.029064,0.029064,7,0.000938,0,0,0,0.097943,0.73355,0
Saaqib,Saaqib,,115,115,230,115,115,230,2,0.530536,0.557558,0.001182,0.036211,0.036211,4,0.001124,0,0,0,0.094127,0.91379,0
Irfan Haider,Irfan Haider,,109,109,218,109,109,218,2,0.528851,0.554555,0.001032,0.03453,0.03453,2,0.001072,0,0,0,0.102446,0.871245,0
Filip,Filip,,107,107,214,107,107,214,2,0.528292,0.553554,0.000992,0.033871,0.033871,2,0.001055,0,0,0,0.10633,0.854691,0
Xanthe,Xanthe,,96,96,192,96,96,192,2,0.525237,0.548048,0.000813,0.030222,0.030222,5,0.000963,0,0,0,0.104167,0.762623,0
Dylan,Dylan,,98,98,196,98,98,196,2,0.525789,0.549049,0.000827,0.031133,0.031133,6,0.000979,0,0,0,0.103514,0.78555,0
Hugo,Hugo,,107,107,214,107,107,214,2,0.528292,0.553554,0.001041,0.033289,0.033289,7,0.001058,0,0,0,0.098924,0.840214,0
Hallie,Hallie,,104,104,208,104,104,208,2,0.527455,0.552052,0.000933,0.033047,0.033047,6,0.00103,0,0,0,0.104182,0.833855,0
Naina Sadiq,Naina Sadiq,,109,109,218,109,109,218,2,0.528851,0.554555,0.001049,0.034278,0.034278,5,0.001073,0,0,0,0.099388,0.865058,0
Indie,Indie,,92,92,184,92,92,184,2,0.524134,0.546046,0.00074,0.029006,0.029006,0,0.000929,0,0,0,0.105112,0.732069,0
Sadiq Nawaz,Sadiq Nawaz,,99,99,198,99,99,198,2,0.526066,0.54955,0.000896,0.030675,0.030675,4,0.00099,0,0,0,0.101629,0.7744,0
Chloe,Chloe,,93,93,186,93,93,186,2,0.524409,0.546547,0.000754,0.029367,0.029367,2,0.000937,0,0,0,0.105657,0.741087,0
Zulqurnain,Zulqurnain,,89,89,178,89,89,178,2,0.523311,0.544545,0.000698,0.027977,0.027977,8,0.000904,0,0,0,0.1024,0.706048,0
Rizwan,Rizwan,,104,104,208,104,104,208,3,0.527177,0.551885,0.000948,0.032799,0.032799,3,0.001031,0,0,0,0.103249,0.827705,0
Muhammad Bilal,Muhammad Bilal,,109,109,218,109,109,218,2,0.528851,0.554555,0.001055,0.034212,0.034212,5,0.001074,0,0,0,0.103466,0.863339,0
Rio,Rio,,100,100,200,100,100,200,2,0.526344,0.55005,0.000903,0.031006,0.031006,6,0.000999,0,0,0,0.102626,0.782662,0
Adam,Adam,,92,92,184,92,92,184,2,0.524134,0.546046,0.00074,0.029067,0.029067,3,0.000929,0,0,0,0.096751,0.733568,0
Ayva,Ayva,,103,103,206,103,103,206,2,0.527177,0.551552,0.000928,0.032608,0.032608,8,0.001022,0,0,0,0.101275,0.822911,0
Abu Fida,Abu Fida,,98,98,196,98,98,196,2,0.525789,0.549049,0.000862,0.030565,0.030565,8,0.000981,0,0,0,0.09636,0.771518,0
Nasrullah,Nasrullah,,99,99,198,99,99,198,2,0.526066,0.54955,0.000861,0.031201,0.031201,3,0.000988,0,0,0,0.100392,0.787317,0
Nazir Ahmed,Nazir Ahmed,,109,109,218,109,109,218,2,0.528851,0.554555,0.001059,0.034085,0.034085,7,0.001074,0,0,0,0.105674,0.860228,0
Benjamin,Benjamin,,83,83,166,83,83,166,2,0.521671,0.541542,0.00062,0.025816,0.025816,8,0.000854,0,0,0,0.099618,0.651722,0
Hafeez,Hafeez,,103,103,206,103,103,206,2,0.527177,0.551552,0.000942,0.032413,0.032413,8,0.001022,0,0,0,0.097658,0.817954,0
Mahnoor,Mahnoor,,92,92,184,92,92,184,2,0.524134,0.546046,0.000734,0.028969,0.028969,0,0.000929,0,0,0,0.10344,0.731075,0
Fathurrochman,Fathurrochman,,112,112,224,112,112,224,2,0.529692,0.556056,0.001121,0.035212,0.035212,8,0.001099,0,0,0,0.101512,0.888644,0
Joshua,Joshua,,106,106,212,106,106,212,2,0.528013,0.553053,0.00102,0.033084,0.033084,2,0.001049,0,0,0,0.09434,0.834985,0
Muhammad Faisal Sheikh,Muhammad Faisal Sheikh,,88,88,176,88,88,176,2,0.523037,0.544044,0.000671,0.027922,0.027922,0,0.000895,0,0,0,0.106322,0.704605,0
Hina,Hina,,92,92,184,92,92,184,2,0.524134,0.546046,0.000754,0.028718,0.028718,3,0.00093,0,0,0,0.102484,0.724894,0
Alyssa,Alyssa,,112,112,224,112,112,224,2,0.529692,0.556056,0.001121,0.035177,0.035177,8,0.001099,0,0,0,0.092181,0.887688,0
Hamid,Hamid,,97,97,194,97,97,194,2,0.525513,0.548549,0.000818,0.030658,0.030658,1,0.000971,0,0,0,0.099656,0.773653,0
Abu Dujanah,Abu Dujanah,,100,100,200,100,100,200,2,0.526344,0.55005,0.000854,0.031885,0.031885,7,0.000995,0,0,0,0.104444,0.804537,0
Rahat Ali,Rahat Ali,,94,94,188,94,94,188,2,0.524685,0.547047,0.000803,0.029191,0.029191,0,0.000948,0,0,0,0.093342,0.736894,0
Fathurrahman al-Ghozi,Fathurrahman al-Ghozi,,97,97,194,97,97,194,2,0.525513,0.548549,0.00087,0.029958,0.029958,3,0.000974,0,0,0,0.096005,0.756307,0
Alexia,Alexia,,100,100,200,100,100,200,2,0.526344,0.55005,0.00093,0.030616,0.030616,7,0.001001,0,0,0,0.104242,0.773008,0
Mehtab Shafiq,Mehtab Shafiq,,100,100,200,100,100,200,2,0.526344,0.55005,0.000883,0.031518,0.031518,0,0.000997,0,0,0,0.095758,0.795373,0
Heri Golun,Heri Golun,,86,86,172,86,86,172,2,0.52249,0.543043,0.000689,0.026537,0.026537,0,0.00088,0,0,0,0.086457,0.669937,0
Helena,Helena,,87,87,174,87,87,174,2,0.522763,0.543544,0.000663,0.027438,0.027438,5,0.000887,0,0,0,0.100508,0.692414,0
Teistan,Teistan,,94,94,188,94,94,188,2,0.524685,0.547047,0.00077,0.029527,0.029527,0,0.000946,0,0,0,0.109357,0.745211,0
Zubair Sial,Zubair Sial,,102,102,204,102,102,204,2,0.526899,0.551051,0.000898,0.032238,0.032238,2,0.001013,0,0,0,0.109882,0.813515,0
Shahnawaz,Shahnawaz,,108,108,216,108,108,216,2,0.528571,0.554054,0.00103,0.033963,0.033963,6,0.001065,0,0,0,0.102285,0.857109,0
Ayyan,Ayyan,,76,76,152,76,76,152,2,0.519771,0.538038,0.000545,0.02313,0.02313,7,0.000797,0,0,0,0.099649,0.58407,0
Darcey,Darcey,,98,98,196,98,98,196,2,0.525789,0.549049,0.000844,0.030805,0.030805,4,0.00098,0,0,0,0.10162,0.777419,0
Happy Bacha,Happy Bacha,,108,108,216,108,108,216,2,0.528571,0.554054,0.001013,0.034334,0.034334,1,0.001063,0,0,0,0.103842,0.866222,0
Missy Harlin  ,Missy Harlin  ,,104,104,208,104,104,208,2,0.527455,0.552052,0.000969,0.032587,0.032587,7,0.001032,0,0,0,0.099328,0.822399,0
Ghulam Rasool,Ghulam Rasool,,95,95,190,95,95,190,2,0.524961,0.547548,0.000825,0.029438,0.029438,8,0.000956,0,0,0,0.095409,0.743196,0
Ubeid,Ubeid,,92,92,184,92,92,184,3,0.523859,0.545879,0.000735,0.028914,0.028914,3,0.000929,0,0,0,0.107979,0.729704,0
Dennis,Dennis,,119,119,238,119,119,238,2,0.531666,0.55956,0.001284,0.037416,0.037416,8,0.001159,0,0,0,0.096995,0.944182,0
Mohammed,Mohammed,,100,100,200,100,100,200,2,0.526344,0.55005,0.000907,0.031221,0.031221,8,0.000998,0,0,0,0.093737,0.788031,0
Evie,Evie,,88,88,176,88,88,176,3,0.522763,0.543877,0.0007,0.027409,0.027409,3,0.000896,0,0,0,0.090648,0.69185,0
Tyker,Tyker,,100,100,200,100,100,200,2,0.526344,0.55005,0.000908,0.030974,0.030974,2,0.000999,0,0,0,0.105253,0.781912,0
Umair Khan,Umair Khan,,94,94,188,94,94,188,2,0.524685,0.547047,0.000778,0.029504,0.029504,5,0.000947,0,0,0,0.100892,0.744614,0
Zachariah,Zachariah,,101,101,202,101,101,202,2,0.526621,0.550551,0.000884,0.032041,0.032041,3,0.001005,0,0,0,0.103366,0.808565,0
Samuel,Samuel,,107,107,214,107,107,214,2,0.528292,0.553554,0.00098,0.03402,0.03402,1,0.001055,0,0,0,0.103862,0.85837,0
Selena,Selena,,92,92,184,92,92,184,2,0.524134,0.546046,0.000774,0.02864,0.02864,8,0.000931,0,0,0,0.095796,0.722988,0
Michael,Michael,,99,99,198,99,99,198,2,0.526066,0.54955,0.000843,0.031343,0.031343,8,0.000988,0,0,0,0.107607,0.791016,0
Jaden,Jaden,,89,89,178,89,89,178,2,0.523311,0.544545,0.00068,0.02828,0.02828,8,0.000903,0,0,0,0.100102,0.713643,0
Edgar,Edgar,,107,107,214,107,107,214,2,0.528292,0.553554,0.000978,0.034169,0.034169,1,0.001054,0,0,0,0.107741,0.862047,0
Farhan,Farhan,,117,117,234,117,117,234,2,0.5311,0.558559,0.001249,0.036498,0.036498,7,0.001143,0,0,0,0.099469,0.921163,0
Shahzad Rasheed,Shahzad Rasheed,,93,93,186,93,93,186,2,0.524409,0.546547,0.000756,0.029439,0.029439,7,0.000937,0,0,0,0.100281,0.742928,0
Salik Firdaus,Salik Firdaus,,101,101,202,101,101,202,2,0.526621,0.550551,0.000898,0.031872,0.031872,5,0.001005,0,0,0,0.101584,0.804309,0
Jasmin,Jasmin,,120,120,240,120,120,240,2,0.531949,0.56006,0.001351,0.036925,0.036925,5,0.00117,0,0,0,0.097479,0.932096,0
Zander,Zander,,79,79,158,79,79,158,2,0.520584,0.53954,0.000542,0.024969,0.024969,7,0.000819,0,0,0,0.107433,0.630081,0
Harvey,Harvey,,89,89,178,89,89,178,3,0.523037,0.544378,0.000705,0.027708,0.027708,2,0.000905,0,0,0,0.101379,0.699434,0
Dani Chandra,Dani Chandra,,97,97,194,97,97,194,2,0.525513,0.548549,0.000812,0.030648,0.030648,7,0.000971,0,0,0,0.109751,0.773435,0
Muhammad Raza Ansari,Muhammad Raza Ansari,,104,104,208,104,104,208,2,0.527455,0.552052,0.000941,0.032908,0.032908,7,0.00103,0,0,0,0.103622,0.830324,0
Isobel,Isobel,,101,101,202,101,101,202,2,0.526621,0.550551,0.000911,0.031488,0.031488,8,0.001007,0,0,0,0.103564,0.794754,0
Muaaz Ur Rehman,Muaaz Ur Rehman,,104,104,208,104,104,208,2,0.527455,0.552052,0.00101,0.032012,0.032012,2,0.001034,0,0,0,0.091486,0.808211,0
Usman Ghani,Usman Ghani,,106,106,212,106,106,212,2,0.528013,0.553053,0.001015,0.033164,0.033164,2,0.001049,0,0,0,0.097934,0.837087,0
Ishku Ishku,Ishku Ishku,,112,112,224,112,112,224,2,0.529692,0.556056,0.001083,0.035649,0.035649,3,0.001097,0,0,0,0.104408,0.899517,0
Faizan Ahmed,Faizan Ahmed,,112,112,224,112,112,224,2,0.529692,0.556056,0.001116,0.035216,0.035216,8,0.001099,0,0,0,0.095721,0.888667,0
Georgina,Georgina,,92,92,184,92,92,184,2,0.524134,0.546046,0.000753,0.028846,0.028846,8,0.00093,0,0,0,0.101051,0.728065,0
Musarrat,Musarrat,,95,95,190,95,95,190,2,0.524961,0.547548,0.000783,0.029987,0.029987,1,0.000954,0,0,0,0.103695,0.756807,0
Junaid,Junaid,,84,84,168,84,84,168,2,0.521944,0.542042,0.000642,0.025921,0.025921,2,0.000863,0,0,0,0.100115,0.654431,0
Bakhtawar,Bakhtawar,,111,111,222,111,111,222,2,0.529412,0.555556,0.001089,0.035019,0.035019,1,0.00109,0,0,0,0.101884,0.883598,0
Ajengan Masduki,Ajengan Masduki,,94,94,188,94,94,188,2,0.524685,0.547047,0.000764,0.029683,0.029683,0,0.000946,0,0,0,0.10501,0.749086,0
Ladla Gee,Ladla Gee,,109,109,218,109,109,218,2,0.528851,0.554555,0.001075,0.033967,0.033967,5,0.001075,0,0,0,0.101767,0.857303,0
Gul Khan,Gul Khan,,100,100,200,100,100,200,2,0.526344,0.55005,0.000874,0.03144,0.03144,6,0.000997,0,0,0,0.10202,0.793437,0
Harrison,Harrison,,88,88,176,88,88,176,2,0.523037,0.544044,0.000692,0.027472,0.027472,0,0.000896,0,0,0,0.102142,0.693367,0
Hassan Sadiq,Hassan Sadiq,,87,87,174,87,87,174,2,0.522763,0.543544,0.0007,0.026892,0.026892,4,0.000889,0,0,0,0.092221,0.678927,0
Minh Adelson  ,Minh Adelson  ,,95,95,190,95,95,190,2,0.524961,0.547548,0.000816,0.029586,0.029586,4,0.000956,0,0,0,0.100784,0.746858,0
Khurrum Gill,Khurrum Gill,,110,110,220,110,110,220,2,0.529131,0.555055,0.001108,0.034119,0.034119,1,0.001084,0,0,0,0.094579,0.861225,0
Ariella,Ariella,,77,77,154,77,77,154,2,0.520042,0.538539,0.000536,0.023919,0.023919,4,0.000803,0,0,0,0.094327,0.60387,0
Waseem,Waseem,,95,95,190,95,95,190,2,0.524961,0.547548,0.000768,0.030433,0.030433,7,0.000953,0,0,0,0.09944,0.76785,0
Brandon,Brandon,,117,117,234,117,117,234,2,0.5311,0.558559,0.001195,0.037019,0.037019,4,0.00114,0,0,0,0.100943,0.934064,0
Zarmeena,Zarmeena,,93,93,186,93,93,186,2,0.524409,0.546547,0.00076,0.029239,0.029239,2,0.000938,0,0,0,0.099112,0.737963,0
Andre,Andre,,98,98,196,98,98,196,2,0.525789,0.549049,0.000847,0.030854,0.030854,4,0.00098,0,0,0,0.102041,0.778645,0
Isobelle,Isobelle,,104,104,208,104,104,208,2,0.527455,0.552052,0.000983,0.032417,0.032417,5,0.001032,0,0,0,0.090926,0.818244,0
Ocean,Ocean,,117,117,234,117,117,234,2,0.5311,0.558559,0.001212,0.03692,0.03692,7,0.001141,0,0,0,0.095785,0.931613,0
Imran,Imran,,103,103,206,103,103,206,2,0.527177,0.551552,0.000948,0.032315,0.032315,4,0.001023,0,0,0,0.101085,0.815568,0
Eesha,Eesha,,102,102,204,102,102,204,2,0.526899,0.551051,0.000934,0.031936,0.031936,4,0.001014,0,0,0,0.098622,0.806048,0
Taskeen,Taskeen,,87,87,174,87,87,174,2,0.522763,0.543544,0.000701,0.026684,0.026684,4,0.00089,0,0,0,0.103448,0.673723,0
Austin,Austin,,87,87,174,87,87,174,2,0.522763,0.543544,0.000669,0.027143,0.027143,2,0.000888,0,0,0,0.099171,0.685167,0
Joseph,Joseph,,97,97,194,97,97,194,2,0.525513,0.548549,0.000837,0.030457,0.030457,5,0.000972,0,0,0,0.099656,0.768565,0
Arsalan,Arsalan,,105,105,210,105,105,210,2,0.527734,0.552553,0.000994,0.03277,0.03277,3,0.00104,0,0,0,0.099451,0.827149,0
Ahmad Rofiq Ridho,Ahmad Rofiq Ridho,,103,103,206,103,103,206,2,0.527177,0.551552,0.000964,0.031978,0.031978,4,0.001024,0,0,0,0.098801,0.80717,0
Muskaan,Muskaan,,85,85,170,85,85,170,2,0.522216,0.542543,0.000655,0.026495,0.026495,7,0.000871,0,0,0,0.098319,0.668776,0
Victoria,Victoria,,85,85,170,85,85,170,2,0.522216,0.542543,0.00066,0.026146,0.026146,7,0.000873,0,0,0,0.10056,0.660174,0
Leona,Leona,,106,106,212,106,106,212,2,0.528013,0.553053,0.000991,0.033504,0.033504,4,0.001047,0,0,0,0.096676,0.845471,0
David,David,,89,89,178,89,89,178,2,0.523311,0.544545,0.000728,0.027576,0.027576,7,0.000906,0,0,0,0.093463,0.696174,0
Jhangir Masood,Jhangir Masood,,101,101,202,101,101,202,2,0.526621,0.550551,0.000917,0.031405,0.031405,4,0.001007,0,0,0,0.100792,0.792739,0
Asmar Latin Sani,Asmar Latin Sani,,86,86,172,86,86,172,3,0.522216,0.542876,0.000675,0.026733,0.026733,2,0.00088,0,0,0,0.093297,0.674776,0
Talha Arshad,Talha Arshad,,106,106,212,106,106,212,3,0.527734,0.552886,0.001008,0.033191,0.033191,3,0.001049,0,0,0,0.101168,0.837649,0
Leah,Leah,,99,99,198,99,99,198,2,0.526066,0.54955,0.000895,0.030634,0.030634,3,0.000991,0,0,0,0.098124,0.773296,0
Lyla,Lyla,,100,100,200,100,100,200,2,0.526344,0.55005,0.000912,0.031054,0.031054,8,0.000999,0,0,0,0.09798,0.783929,0
Carlos,Carlos,,102,102,204,102,102,204,2,0.526899,0.551051,0.000929,0.031989,0.031989,2,0.001014,0,0,0,0.104057,0.807437,0
Mansoor Jhangir,Mansoor Jhangir,,97,97,194,97,97,194,2,0.525513,0.548549,0.000835,0.030421,0.030421,4,0.000972,0,0,0,0.099227,0.767781,0
Hasnat Ahmed Khan,Hasnat Ahmed Khan,,105,105,210,105,105,210,2,0.527734,0.552553,0.000976,0.032975,0.032975,1,0.00104,0,0,0,0.104579,0.832225,0
Caron Delapena  ,Caron Delapena  ,,109,109,218,109,109,218,2,0.528851,0.554555,0.001093,0.03385,0.03385,2,0.001075,0,0,0,0.09633,0.854418,0
Issac Montas  ,Issac Montas  ,,101,101,202,101,101,202,2,0.526621,0.550551,0.000918,0.031547,0.031547,8,0.001007,0,0,0,0.100198,0.796262,0
Crystal Batson  ,Crystal Batson  ,,89,89,178,89,89,178,2,0.523311,0.544545,0.0007,0.028077,0.028077,5,0.000904,0,0,0,0.092697,0.708504,0
Charles,Charles,,106,106,212,106,106,212,2,0.528013,0.553053,0.00102,0.033071,0.033071,4,0.001049,0,0,0,0.097215,0.834695,0
Hashim Jutt,Hashim Jutt,,107,107,214,107,107,214,2,0.528292,0.553554,0.001029,0.033424,0.033424,2,0.001057,0,0,0,0.102275,0.843585,0
Heidi,Heidi,,87,87,174,87,87,174,2,0.522763,0.543544,0.000668,0.027413,0.027413,2,0.000887,0,0,0,0.100241,0.691854,0
Raani,Raani,,108,108,216,108,108,216,2,0.528571,0.554054,0.001041,0.033863,0.033863,3,0.001066,0,0,0,0.101073,0.854559,0
Louie,Louie,,94,94,188,94,94,188,2,0.524685,0.547047,0.000777,0.029556,0.029556,2,0.000946,0,0,0,0.099062,0.745893,0
Elsa,Elsa,,99,99,198,99,99,198,2,0.526066,0.54955,0.000854,0.03116,0.03116,2,0.000988,0,0,0,0.096887,0.786421,0
Haris hassan,Haris hassan,,99,99,198,99,99,198,2,0.526066,0.54955,0.00087,0.031252,0.031253,1,0.000988,0,0,0,0.096681,0.788647,0
Hassan,Hassan,,107,107,214,107,107,214,2,0.528292,0.553554,0.001021,0.03348,0.03348,0,0.001057,0,0,0,0.100335,0.844977,0
Noah,Noah,,91,91,182,91,91,182,2,0.523859,0.545546,0.000727,0.028623,0.028623,2,0.000921,0,0,0,0.101343,0.722471,0
Fahad Malik,Fahad Malik,,93,93,186,93,93,186,2,0.524409,0.546547,0.000789,0.028885,0.028885,8,0.000939,0,0,0,0.09654,0.729125,0
Cholily,Cholily,,100,100,200,100,100,200,2,0.526344,0.55005,0.000863,0.031562,0.031562,7,0.000997,0,0,0,0.104646,0.796463,0
Shahzada Khurram,Shahzada Khurram,,93,93,186,93,93,186,2,0.524409,0.546547,0.000777,0.029048,0.029048,2,0.000939,0,0,0,0.101683,0.733209,0
Anif Solchanudin,Anif Solchanudin,,93,93,186,93,93,186,2,0.524409,0.546547,0.00075,0.02947,0.02947,7,0.000937,0,0,0,0.098878,0.743642,0
Wasil,Wasil,,106,106,212,106,106,212,2,0.528013,0.553053,0.000984,0.033545,0.033545,4,0.001047,0,0,0,0.104043,0.846416,0
Angelina,Angelina,,104,104,208,104,104,208,2,0.527455,0.552052,0.000927,0.032929,0.032929,2,0.00103,0,0,0,0.102315,0.830927,0
Luke,Luke,,88,88,176,88,88,176,2,0.523037,0.544044,0.000688,0.027497,0.027497,8,0.000896,0,0,0,0.105277,0.694048,0
Zaib Khan,Zaib Khan,,96,96,192,96,96,192,2,0.525237,0.548048,0.000813,0.03002,0.03002,2,0.000964,0,0,0,0.105702,0.757618,0
Toni Togar,Toni Togar,,111,111,222,111,111,222,2,0.529412,0.555556,0.00112,0.034557,0.034557,4,0.001092,0,0,0,0.095168,0.872267,0
Lucas,Lucas,,80,80,160,80,80,160,2,0.520855,0.54004,0.000554,0.025416,0.025416,4,0.000827,0,0,0,0.099684,0.641438,0
Leika,Leika,,102,102,204,102,102,204,2,0.526899,0.551051,0.000915,0.032116,0.032116,8,0.001014,0,0,0,0.099786,0.81046,0
Blake,Blake,,99,99,198,99,99,198,2,0.526066,0.54955,0.000894,0.030702,0.030702,0,0.00099,0,0,0,0.102453,0.775067,0
Zain,Zain,,106,106,212,106,106,212,2,0.528013,0.553053,0.001004,0.033327,0.033327,7,0.001048,0,0,0,0.097394,0.84107,0
Abdul Hanan,Abdul Hanan,,102,102,204,102,102,204,2,0.526899,0.551051,0.00093,0.031948,0.031948,8,0.001015,0,0,0,0.096486,0.806317,0
Matloob,Matloob,,90,90,180,90,90,180,2,0.523585,0.545045,0.000712,0.028234,0.028234,2,0.000913,0,0,0,0.10437,0.712627,0
Tu Viloria  ,Tu Viloria  ,,87,87,174,87,87,174,2,0.522763,0.543544,0.000658,0.027382,0.027382,1,0.000887,0,0,0,0.10826,0.691031,0
Jamie,Jamie,,101,101,202,101,101,202,2,0.526621,0.550551,0.000916,0.031509,0.031509,2,0.001006,0,0,0,0.099802,0.795325,0
Paulina,Paulina,,107,107,214,107,107,214,2,0.528292,0.553554,0.001057,0.033124,0.033124,7,0.001059,0,0,0,0.096808,0.836107,0
Bekham,Bekham,,109,109,218,109,109,218,2,0.528851,0.554555,0.001041,0.034399,0.034399,7,0.001073,0,0,0,0.099898,0.868002,0
Lauren,Lauren,,85,85,170,85,85,170,2,0.522216,0.542543,0.000634,0.026718,0.026718,5,0.00087,0,0,0,0.09916,0.674348,0
Harriet,Harriet,,96,96,192,96,96,192,2,0.525237,0.548048,0.000809,0.030247,0.030247,7,0.000963,0,0,0,0.095833,0.763293,0
Kashif Karamt,Kashif Karamt,,106,106,212,106,106,212,2,0.528013,0.553053,0.000987,0.033434,0.033434,4,0.001048,0,0,0,0.106559,0.843697,0
Saffron,Saffron,,98,98,196,98,98,196,2,0.525789,0.549049,0.000849,0.030886,0.030886,1,0.00098,0,0,0,0.100989,0.779465,0
Engr Sid Awan,Engr Sid Awan,,101,101,202,101,101,202,2,0.526621,0.550551,0.000929,0.031322,0.031322,2,0.001007,0,0,0,0.098614,0.79057,0
Enceng Kurnia,Enceng Kurnia,,108,108,216,108,108,216,2,0.528571,0.554054,0.001044,0.03388,0.03388,1,0.001065,0,0,0,0.098477,0.854986,0
Peter,Peter,,78,78,156,78,78,156,2,0.520312,0.539039,0.000525,0.024896,0.024896,4,0.000809,0,0,0,0.097902,0.628262,0
Louis,Louis,,99,99,198,99,99,198,2,0.526066,0.54955,0.00087,0.031097,0.031097,5,0.000989,0,0,0,0.104308,0.784759,0
Lillie,Lillie,,101,101,202,101,101,202,2,0.526621,0.550551,0.000914,0.031651,0.031651,7,0.001006,0,0,0,0.1,0.798829,0
Jasper,Jasper,,94,94,188,94,94,188,2,0.524685,0.547047,0.000794,0.029346,0.029346,1,0.000947,0,0,0,0.0938,0.740798,0
Azhar,Azhar,,90,90,180,90,90,180,2,0.523585,0.545045,0.000711,0.028371,0.028371,5,0.000912,0,0,0,0.099126,0.716019,0
Orla,Orla,,91,91,182,91,91,182,2,0.523859,0.545546,0.000713,0.02873,0.02873,0,0.00092,0,0,0,0.105495,0.724995,0
Abu Bakar,Abu Bakar,,95,95,190,95,95,190,2,0.524961,0.547548,0.000792,0.029902,0.029902,5,0.000955,0,0,0,0.100336,0.754649,0
Hassan Bhatti,Hassan Bhatti,,106,106,212,106,106,212,2,0.528013,0.553053,0.001005,0.033335,0.033335,2,0.001048,0,0,0,0.092363,0.841219,0
Ahmed,Ahmed,,123,123,246,123,123,246,2,0.5328,0.561562,0.00136,0.038496,0.038496,3,0.001193,0,0,0,0.101426,0.971503,0
Abdullah Butt,Abdullah Butt,,90,90,180,90,90,180,2,0.523585,0.545045,0.00069,0.028807,0.028807,4,0.00091,0,0,0,0.102372,0.726771,0
Asad Ali,Asad Ali,,99,99,198,99,99,198,2,0.526066,0.54955,0.000879,0.031099,0.031099,3,0.000989,0,0,0,0.093383,0.784911,0
Akhtar Munir,Akhtar Munir,,84,84,168,84,84,168,2,0.521944,0.542042,0.000646,0.025894,0.025894,4,0.000864,0,0,0,0.098107,0.653688,0
Saif,Saif,,106,106,212,106,106,212,2,0.528013,0.553053,0.000993,0.033194,0.033194,6,0.001049,0,0,0,0.101348,0.837738,0
Aimee,Aimee,,92,92,184,92,92,184,2,0.524134,0.546046,0.000735,0.029225,0.029225,2,0.000928,0,0,0,0.100096,0.737502,0
Abdullah Abid,Abdullah Abid,,110,110,220,110,110,220,2,0.529131,0.555055,0.001058,0.034885,0.034885,1,0.001081,0,0,0,0.101251,0.88014,0
Conor,Conor,,89,89,178,89,89,178,2,0.523311,0.544545,0.000676,0.028329,0.028329,7,0.000903,0,0,0,0.104954,0.714785,0
Zidane,Zidane,,91,91,182,91,91,182,2,0.523859,0.545546,0.000737,0.02839,0.02839,4,0.000922,0,0,0,0.101099,0.716703,0
Danuta Caylor  ,Danuta Caylor  ,,102,102,204,102,102,204,2,0.526899,0.551051,0.000916,0.032176,0.032176,1,0.001014,0,0,0,0.100175,0.811957,0
Dusty Passarelli  ,Dusty Passarelli  ,,103,103,206,103,103,206,2,0.527177,0.551552,0.000955,0.032197,0.032197,1,0.001023,0,0,0,0.092519,0.812647,0
Wilhelmina Monsour  ,Wilhelmina Monsour  ,,100,100,200,100,100,200,2,0.526344,0.55005,0.000901,0.031123,0.031123,2,0.000998,0,0,0,0.096768,0.785607,0
Iqbal,Iqbal,,91,91,182,91,91,182,2,0.523859,0.545546,0.000712,0.028929,0.028929,2,0.00092,0,0,0,0.098168,0.730039,0
Denno,Denno,,86,86,172,86,86,172,2,0.52249,0.543043,0.000655,0.02693,0.02693,2,0.000879,0,0,0,0.102326,0.679667,0
Gabriela,Gabriela,,95,95,190,95,95,190,2,0.524961,0.547548,0.000819,0.029505,0.029505,2,0.000956,0,0,0,0.094737,0.744815,0
Kattie,Kattie,,110,110,220,110,110,220,2,0.529131,0.555055,0.001071,0.034435,0.034435,2,0.001082,0,0,0,0.102252,0.869018,0
Suleman,Suleman,,105,105,210,105,105,210,2,0.527734,0.552553,0.000958,0.033436,0.033436,1,0.001038,0,0,0,0.103114,0.843768,0
Liam,Liam,,88,88,176,88,88,176,2,0.523037,0.544044,0.000669,0.027791,0.027791,6,0.000895,0,0,0,0.100313,0.701274,0
Zeeshan,Zeeshan,,94,94,188,94,94,188,2,0.524685,0.547047,0.000762,0.029782,0.029782,6,0.000945,0,0,0,0.103638,0.751477,0
Jackson,Jackson,,105,105,210,105,105,210,2,0.527734,0.552553,0.000961,0.033216,0.033216,5,0.001039,0,0,0,0.105128,0.838162,0
Freddie,Freddie,,112,112,224,112,112,224,2,0.529692,0.556056,0.001127,0.034943,0.034943,5,0.0011,0,0,0,0.100386,0.881962,0
Vriab,Vriab,,83,83,166,83,83,166,2,0.521671,0.541542,0.000591,0.026321,0.026321,1,0.000852,0,0,0,0.105495,0.66426,0
Tobias,Tobias,,104,104,208,104,104,208,2,0.527455,0.552052,0.000946,0.032979,0.032979,4,0.00103,0,0,0,0.096527,0.832179,0
Wajeeha,Wajeeha,,106,106,212,106,106,212,2,0.528013,0.553053,0.00097,0.033606,0.033606,4,0.001047,0,0,0,0.110332,0.847953,0
William,William,,117,117,234,117,117,234,2,0.5311,0.558559,0.001253,0.036251,0.036251,7,0.001144,0,0,0,0.098438,0.915001,0
Warren,Warren,,111,111,222,111,111,222,3,0.529131,0.555389,0.001102,0.034709,0.034709,6,0.001091,0,0,0,0.103358,0.875921,0
Andrew,Andrew,,98,98,196,98,98,196,2,0.525789,0.549049,0.000837,0.031013,0.031013,4,0.000979,0,0,0,0.104776,0.782589,0
Khawaja TK Khan,Khawaja TK Khan,,103,103,206,103,103,206,2,0.527177,0.551552,0.000951,0.032235,0.032235,2,0.001023,0,0,0,0.101466,0.813567,0
Scarlet,Scarlet,,100,100,200,100,100,200,2,0.526344,0.55005,0.000897,0.031309,0.031309,5,0.000998,0,0,0,0.097172,0.790189,0
Fizza Malik,Fizza Malik,,109,109,218,109,109,218,2,0.528851,0.554555,0.00106,0.03432,0.03432,1,0.001073,0,0,0,0.098029,0.866023,0
Heri Sigu Samboja,Heri Sigu Samboja,,100,100,200,100,100,200,2,0.526344,0.55005,0.000899,0.031121,0.031121,3,0.000998,0,0,0,0.10101,0.78552,0
Umar,Umar,,98,98,196,98,98,196,2,0.525789,0.549049,0.00086,0.030491,0.030491,1,0.000982,0,0,0,0.10162,0.769595,0
Emma,Emma,,121,121,242,121,121,242,2,0.532232,0.560561,0.001327,0.037686,0.037686,8,0.001176,0,0,0,0.097934,0.951148,0
Lola,Lola,,109,109,218,109,109,218,2,0.528851,0.554555,0.001063,0.034114,0.034114,3,0.001074,0,0,0,0.099388,0.860976,0
Muhammad Khalil,Muhammad Khalil,,104,104,208,104,104,208,3,0.527177,0.551885,0.000935,0.03317,0.03317,4,0.001029,0,0,0,0.098954,0.83693,0
Hailey,Hailey,,92,92,184,92,92,184,2,0.524134,0.546046,0.000749,0.029066,0.029066,6,0.000929,0,0,0,0.096034,0.733434,0
Sanjay,Sanjay,,103,103,206,103,103,206,2,0.527177,0.551552,0.00094,0.032461,0.032461,7,0.001022,0,0,0,0.092328,0.819192,0
Harman,Harman,,98,98,196,98,98,196,2,0.525789,0.549049,0.00085,0.030751,0.030751,0,0.00098,0,0,0,0.101199,0.776071,0
Abigail,Abigail,,93,93,186,93,93,186,2,0.524409,0.546547,0.000776,0.028945,0.028945,8,0.000939,0,0,0,0.100748,0.730641,0
Olly,Olly,,106,106,212,106,106,212,2,0.528013,0.553053,0.00102,0.032939,0.032939,1,0.001049,0,0,0,0.100988,0.83145,0
Daisy,Daisy,,96,96,192,96,96,192,2,0.525237,0.548048,0.00082,0.030148,0.030148,7,0.000964,0,0,0,0.107237,0.760876,0
Macie,Macie,,111,111,222,111,111,222,2,0.529412,0.555556,0.001122,0.034577,0.034577,1,0.001092,0,0,0,0.097461,0.872662,0
Gracie,Gracie,,92,92,184,92,92,184,2,0.524134,0.546046,0.000764,0.028663,0.028663,8,0.000931,0,0,0,0.098423,0.723522,0
Allah Baksh,Allah Baksh,,117,117,234,117,117,234,2,0.5311,0.558559,0.001242,0.036479,0.036479,4,0.001142,0,0,0,0.092543,0.920643,0
Sohail,Sohail,,92,92,184,92,92,184,2,0.524134,0.546046,0.000746,0.02893,0.02893,1,0.000929,0,0,0,0.098184,0.730154,0
Keiron,Keiron,,86,86,172,86,86,172,2,0.52249,0.543043,0.000654,0.027012,0.027012,7,0.000879,0,0,0,0.099042,0.681751,0
Tayla,Tayla,,102,102,204,102,102,204,2,0.526899,0.551051,0.000909,0.032327,0.032327,8,0.001013,0,0,0,0.101922,0.815731,0
Sophia,Sophia,,92,92,184,92,92,184,2,0.524134,0.546046,0.000746,0.028962,0.028962,8,0.000929,0,0,0,0.099618,0.730904,0
Owen,Owen,,88,88,176,88,88,176,2,0.523037,0.544044,0.000685,0.027669,0.027669,2,0.000895,0,0,0,0.096134,0.698358,0
Roxie,Roxie,,94,94,188,94,94,188,2,0.524685,0.547047,0.000796,0.02932,0.02932,0,0.000947,0,0,0,0.096317,0.740103,0
Sara,Sara,,94,94,188,94,94,188,2,0.524685,0.547047,0.000816,0.029076,0.029076,3,0.000948,0,0,0,0.097003,0.733995,0
Saskia,Saskia,,102,102,204,102,102,204,2,0.526899,0.551051,0.000896,0.032486,0.032486,8,0.001012,0,0,0,0.105222,0.819678,0
Lottie,Lottie,,83,83,166,83,83,166,2,0.521671,0.541542,0.00061,0.026055,0.026055,4,0.000853,0,0,0,0.096973,0.657655,0
Sardona Siliwangi,Sardona Siliwangi,,105,105,210,105,105,210,2,0.527734,0.552553,0.000956,0.033406,0.033406,8,0.001038,0,0,0,0.098168,0.842767,0
Mus'ab Sahidi,Mus'ab Sahidi,,94,94,188,94,94,188,2,0.524685,0.547047,0.000783,0.029614,0.029614,0,0.000946,0,0,0,0.092885,0.747328,0
Faizy Yar,Faizy Yar,,94,94,188,94,94,188,2,0.524685,0.547047,0.00078,0.029702,0.029702,8,0.000946,0,0,0,0.099062,0.7495,0
Sumaiya,Sumaiya,,111,111,222,111,111,222,2,0.529412,0.555556,0.001087,0.034737,0.034737,1,0.001091,0,0,0,0.102539,0.876732,0
Tony,Tony,,103,103,206,103,103,206,2,0.527177,0.551552,0.000947,0.032281,0.032281,2,0.001023,0,0,0,0.101085,0.814655,0
Andleeb,Andleeb,,90,90,180,90,90,180,2,0.523585,0.545045,0.000724,0.028179,0.028179,2,0.000913,0,0,0,0.101873,0.711259,0
Hassaan,Hassaan,,93,93,186,93,93,186,2,0.524409,0.546547,0.000776,0.02897,0.02897,8,0.000939,0,0,0,0.100982,0.731237,0
Sibgha,Sibgha,,109,109,218,109,109,218,2,0.528851,0.554555,0.001066,0.034028,0.034028,1,0.001074,0,0,0,0.099388,0.858811,0
Sammi,Sammi,,100,100,200,100,100,200,2,0.526344,0.55005,0.000869,0.03149,0.03149,3,0.000997,0,0,0,0.103434,0.794628,0
Cody,Cody,,98,98,196,98,98,196,2,0.525789,0.549049,0.000846,0.031005,0.031005,0,0.000979,0,0,0,0.093415,0.782421,0
Murk Latif,Murk Latif,,89,89,178,89,89,178,2,0.523311,0.544545,0.00071,0.027742,0.027742,5,0.000905,0,0,0,0.100868,0.700233,0
Baharudin Soleh,Baharudin Soleh,,112,112,224,112,112,224,2,0.529692,0.556056,0.001108,0.035402,0.035402,0,0.001098,0,0,0,0.104891,0.893274,0
Riley,Riley,,97,97,194,97,97,194,2,0.525513,0.548549,0.000886,0.029674,0.029674,8,0.000975,0,0,0,0.092139,0.74918,0
Lorenzo,Lorenzo,,86,86,172,86,86,172,2,0.52249,0.543043,0.000668,0.026752,0.026752,2,0.00088,0,0,0,0.093023,0.675371,0
Casper,Casper,,98,98,196,98,98,196,2,0.525789,0.549049,0.000844,0.030784,0.030784,7,0.00098,0,0,0,0.10141,0.776905,0
Zafar,Zafar,,91,91,182,91,91,182,2,0.523859,0.545546,0.000729,0.02862,0.02862,0,0.000921,0,0,0,0.098901,0.722272,0
Lara,Lara,,99,99,198,99,99,198,2,0.526066,0.54955,0.000866,0.031051,0.031051,0,0.000989,0,0,0,0.103072,0.783661,0
Maddison,Maddison,,103,103,206,103,103,206,2,0.527177,0.551552,0.000929,0.03255,0.03255,0,0.001022,0,0,0,0.101847,0.821429,0
Ratchel,Ratchel,,106,106,212,106,106,212,2,0.528013,0.553053,0.000988,0.033486,0.033486,8,0.001047,0,0,0,0.099191,0.844995,0
Jonah,Jonah,,100,100,200,100,100,200,2,0.526344,0.55005,0.000898,0.031231,0.031231,8,0.000998,0,0,0,0.102424,0.78824,0
Irum,Irum,,89,89,178,89,89,178,2,0.523311,0.544545,0.000697,0.028022,0.028022,1,0.000904,0,0,0,0.10189,0.707295,0
Mariyam,Mariyam,,98,98,196,98,98,196,2,0.525789,0.549049,0.000887,0.030134,0.030134,1,0.000983,0,0,0,0.094887,0.760672,0
Niaz Ahmed,Niaz Ahmed,,119,119,238,119,119,238,2,0.531666,0.55956,0.001315,0.036684,0.036684,5,0.001161,0,0,0,0.09728,0.925976,0
Zeeshan Khan,Zeeshan Khan,,80,80,160,80,80,160,3,0.520584,0.539873,0.000568,0.024968,0.024968,8,0.000829,0,0,0,0.104114,0.63027,0
Esther,Esther,,89,89,178,89,89,178,2,0.523311,0.544545,0.000703,0.027854,0.027854,1,0.000905,0,0,0,0.104699,0.703019,0
Amjad,Amjad,,106,106,212,106,106,212,2,0.528013,0.553053,0.000981,0.033624,0.033624,2,0.001047,0,0,0,0.100449,0.848439,0
Maroof,Maroof,,93,93,186,93,93,186,2,0.524409,0.546547,0.000766,0.029093,0.029093,7,0.000938,0,0,0,0.101216,0.734321,0
Elijah,Elijah,,107,107,214,107,107,214,2,0.528292,0.553554,0.001006,0.033813,0.033813,6,0.001056,0,0,0,0.107036,0.853172,0
Kyran,Kyran,,106,106,212,106,106,212,2,0.528013,0.553053,0.001018,0.033007,0.033007,4,0.001049,0,0,0,0.09434,0.833125,0
Saqib,Saqib,,105,105,210,105,105,210,2,0.527734,0.552553,0.000996,0.032706,0.032706,8,0.001041,0,0,0,0.099451,0.82556,0
Mabele,Mabele,,106,106,212,106,106,212,2,0.528013,0.553053,0.000995,0.033372,0.033372,2,0.001048,0,0,0,0.10584,0.842192,0
Fawad Khan,Fawad Khan,,90,90,180,90,90,180,2,0.523585,0.545045,0.000719,0.028179,0.028179,1,0.000913,0,0,0,0.101373,0.711198,0
Reid,Reid,,77,77,154,77,77,154,3,0.519771,0.538372,0.000523,0.024027,0.024027,7,0.000803,0,0,0,0.105263,0.606489,0
Amelie,Amelie,,98,98,196,98,98,196,2,0.525789,0.549049,0.000853,0.030675,0.030675,2,0.000981,0,0,0,0.094467,0.774267,0
Jabar,Jabar,,95,95,190,95,95,190,2,0.524961,0.547548,0.000819,0.029707,0.029707,3,0.000956,0,0,0,0.094737,0.749797,0
Ada,Ada,,100,100,200,100,100,200,2,0.526344,0.55005,0.000884,0.031407,0.031407,1,0.000997,0,0,0,0.099798,0.792687,0
Aisha,Aisha,,87,87,174,87,87,174,2,0.522763,0.543544,0.000669,0.027397,0.027397,6,0.000887,0,0,0,0.098904,0.691422,0
Hollie,Hollie,,109,109,218,109,109,218,2,0.528851,0.554555,0.00108,0.033919,0.033919,4,0.001075,0,0,0,0.099218,0.856151,0
Lema,Lema,,108,108,216,108,108,216,2,0.528571,0.554054,0.001025,0.033932,0.033932,2,0.001065,0,0,0,0.106265,0.856384,0
Luka,Luka,,101,101,202,101,101,202,2,0.526621,0.550551,0.000931,0.03144,0.03144,3,0.001007,0,0,0,0.091485,0.793551,0
Burhan,Burhan,,102,102,204,102,102,204,2,0.526899,0.551051,0.00092,0.032126,0.032126,8,0.001014,0,0,0,0.103281,0.810771,0
Jahangir,Jahangir,,90,90,180,90,90,180,2,0.523585,0.545045,0.000724,0.028066,0.028066,3,0.000913,0,0,0,0.102871,0.708499,0
Salman Madni,Salman Madni,,105,105,210,105,105,210,2,0.527734,0.552553,0.001018,0.032329,0.032329,4,0.001042,0,0,0,0.097802,0.816146,0
Diya,Diya,,84,84,168,84,84,168,2,0.521944,0.542042,0.000621,0.02645,0.02645,0,0.000861,0,0,0,0.096959,0.667527,0
Salmaan,Salmaan,,108,108,216,108,108,216,2,0.528571,0.554054,0.001056,0.033473,0.033473,2,0.001067,0,0,0,0.101765,0.844954,0
Hamdaan,Hamdaan,,105,105,210,105,105,210,2,0.527734,0.552553,0.000984,0.0332,0.0332,7,0.001039,0,0,0,0.096703,0.837762,0
Tahir Qadri,Tahir Qadri,,93,93,186,93,93,186,2,0.524409,0.546547,0.000774,0.029063,0.029063,7,0.000938,0,0,0,0.093735,0.733591,0
Terrance Langone  ,Terrance Langone  ,,102,102,204,102,102,204,2,0.526899,0.551051,0.000882,0.032584,0.032584,8,0.001012,0,0,0,0.108134,0.822098,0
Mee Galli  ,Mee Galli  ,,109,109,218,109,109,218,2,0.528851,0.554555,0.001065,0.034107,0.034107,8,0.001074,0,0,0,0.102107,0.860887,0
Alesia Fain  ,Alesia Fain  ,,102,102,204,102,102,204,2,0.526899,0.551051,0.000914,0.032134,0.032134,3,0.001014,0,0,0,0.100175,0.810847,0
Aslam Kakkar,Aslam Kakkar,,103,103,206,103,103,206,2,0.527177,0.551552,0.00096,0.03196,0.03196,2,0.001024,0,0,0,0.099181,0.806732,0
Zak,Zak,,105,105,210,105,105,210,2,0.527734,0.552553,0.000951,0.033191,0.033191,0,0.001039,0,0,0,0.109707,0.837638,0
Matilda,Matilda,,100,100,200,100,100,200,2,0.526344,0.55005,0.000891,0.031411,0.031411,4,0.000997,0,0,0,0.100606,0.792641,0
Imogen,Imogen,,102,102,204,102,102,204,2,0.526899,0.551051,0.00094,0.0318,0.0318,0,0.001015,0,0,0,0.094156,0.802601,0
Thatcher,Thatcher,,86,86,172,86,86,172,2,0.52249,0.543043,0.000657,0.026842,0.026842,5,0.00088,0,0,0,0.10342,0.677562,0
Usman,Usman,,111,111,222,111,111,222,2,0.529412,0.555556,0.001068,0.035285,0.035285,6,0.001089,0,0,0,0.100737,0.890181,0
Misbah,Misbah,,97,97,194,97,97,194,3,0.525237,0.548382,0.000863,0.030048,0.030048,3,0.000974,0,0,0,0.092998,0.758476,0
Elise,Elise,,92,92,184,92,92,184,2,0.524134,0.546046,0.00074,0.029179,0.029179,7,0.000928,0,0,0,0.091973,0.736256,0
Ronan,Ronan,,91,91,182,91,91,182,2,0.523859,0.545546,0.000763,0.028079,0.028079,7,0.000923,0,0,0,0.094505,0.708826,0
Aleena,Aleena,,107,107,214,107,107,214,2,0.528292,0.553554,0.001035,0.033475,0.033475,3,0.001057,0,0,0,0.095398,0.844824,0
Faith,Faith,,103,103,206,103,103,206,2,0.527177,0.551552,0.000932,0.032554,0.032554,6,0.001022,0,0,0,0.100895,0.821473,0
Zulfiqar,Zulfiqar,,100,100,200,100,100,200,2,0.526344,0.55005,0.000897,0.031143,0.031143,2,0.000998,0,0,0,0.09697,0.786047,0
Lewis,Lewis,,95,95,190,95,95,190,2,0.524961,0.547548,0.000803,0.02987,0.02987,4,0.000955,0,0,0,0.095857,0.753892,0
Sandra,Sandra,,98,98,196,98,98,196,2,0.525789,0.549049,0.000876,0.030342,0.030342,3,0.000982,0,0,0,0.104145,0.765975,0
Engkos Kosasih,Engkos Kosasih,,127,127,254,127,127,254,2,0.533939,0.563564,0.001468,0.039512,0.039512,6,0.001227,0,0,0,0.099863,0.997248,0
Iwan Dharmawan,Iwan Dharmawan,,87,87,174,87,87,174,2,0.522763,0.543544,0.000681,0.027045,0.027045,0,0.000888,0,0,0,0.10131,0.682758,0
Shahid,Shahid,,95,95,190,95,95,190,2,0.524961,0.547548,0.000823,0.029467,0.029467,3,0.000956,0,0,0,0.096305,0.74387,0
Eihanna,Eihanna,,96,96,192,96,96,192,2,0.525237,0.548048,0.000812,0.030276,0.030276,2,0.000963,0,0,0,0.101535,0.764067,0
Fahad,Fahad,,87,87,174,87,87,174,2,0.522763,0.543544,0.00065,0.02756,0.02756,8,0.000886,0,0,0,0.103716,0.695422,0
Ismail,Ismail,,119,119,238,119,119,238,2,0.531666,0.55956,0.001265,0.037195,0.037195,0,0.001159,0,0,0,0.101695,0.938673,0
Fariiddu Khan,Fariiddu Khan,,103,103,206,103,103,206,2,0.527177,0.551552,0.000926,0.032569,0.032569,4,0.001022,0,0,0,0.09861,0.821878,0
Said Sungkar,Said Sungkar,,93,93,186,93,93,186,2,0.524409,0.546547,0.000767,0.029173,0.029173,0,0.000938,0,0,0,0.098644,0.736289,0
Carmen,Carmen,,94,94,188,94,94,188,2,0.524685,0.547047,0.000761,0.029875,0.029875,8,0.000945,0,0,0,0.10501,0.753866,0
Son Hadi,Son Hadi,,95,95,190,95,95,190,2,0.524961,0.547548,0.000808,0.02969,0.02969,0,0.000956,0,0,0,0.103247,0.749416,0
John,John,,112,112,224,112,112,224,2,0.529692,0.556056,0.001117,0.03529,0.03529,8,0.001099,0,0,0,0.107786,0.890546,0
Sarwar,Sarwar,,96,96,192,96,96,192,2,0.525237,0.548048,0.000768,0.030716,0.030716,0,0.000961,0,0,0,0.114254,0.77498,0
Ubaid,Ubaid,,99,99,198,99,99,198,2,0.526066,0.54955,0.000877,0.030955,0.030955,3,0.000989,0,0,0,0.099567,0.781376,0
Martina,Martina,,98,98,196,98,98,196,2,0.525789,0.549049,0.000868,0.030469,0.030469,4,0.000981,0,0,0,0.094467,0.769095,0
Gohar Ahmed Zai,Gohar Ahmed Zai,,102,102,204,102,102,204,2,0.526899,0.551051,0.000931,0.031933,0.031933,5,0.001015,0,0,0,0.102504,0.805965,0
Hasnain,Hasnain,,99,99,198,99,99,198,2,0.526066,0.54955,0.000864,0.031126,0.031126,8,0.000989,0,0,0,0.101422,0.785508,0
Imam Bukhori,Imam Bukhori,,114,114,228,114,114,228,2,0.530255,0.557057,0.001211,0.035212,0.035212,7,0.001118,0,0,0,0.093619,0.888823,0
Muchtar,Muchtar,,98,98,196,98,98,196,2,0.525789,0.549049,0.000879,0.030309,0.030309,1,0.000982,0,0,0,0.095098,0.765083,0
Eiley,Eiley,,111,111,222,111,111,222,2,0.529412,0.555556,0.001093,0.034942,0.034942,7,0.00109,0,0,0,0.096314,0.881778,0
Adnan Shah,Adnan Shah,,99,99,198,99,99,198,2,0.526066,0.54955,0.00088,0.031018,0.031018,7,0.000989,0,0,0,0.095032,0.78286,0
Khalid Rehman,Khalid Rehman,,110,110,220,110,110,220,2,0.529131,0.555055,0.001082,0.03445,0.03445,8,0.001083,0,0,0,0.101418,0.869418,0
Jayden,Jayden,,102,102,204,102,102,204,2,0.526899,0.551051,0.000936,0.031905,0.031905,3,0.001015,0,0,0,0.102504,0.805242,0
Ashiq Balooch,Ashiq Balooch,,102,102,204,102,102,204,2,0.526899,0.551051,0.000937,0.03166,0.03166,6,0.001016,0,0,0,0.101728,0.7992,0
Walayat Hussain Baloch,Walayat Hussain Baloch,,97,97,194,97,97,194,2,0.525513,0.548549,0.000839,0.030506,0.030506,3,0.000972,0,0,0,0.103952,0.769948,0
Caelan,Caelan,,102,102,204,102,102,204,2,0.526899,0.551051,0.000931,0.031929,0.031929,2,0.001015,0,0,0,0.098816,0.805767,0
Saqib Butt,Saqib Butt,,98,98,196,98,98,196,2,0.525789,0.549049,0.000841,0.030961,0.030961,2,0.00098,0,0,0,0.100358,0.781283,0
Shoaib,Shoaib,,87,87,174,87,87,174,3,0.52249,0.543377,0.000657,0.027574,0.027574,6,0.000886,0,0,0,0.100508,0.695819,0
Marcelo,Marcelo,,108,108,216,108,108,216,2,0.528571,0.554054,0.001017,0.034263,0.034263,1,0.001064,0,0,0,0.105227,0.864586,0
Evan,Evan,,88,88,176,88,88,176,2,0.523037,0.544044,0.000669,0.027934,0.027934,6,0.000895,0,0,0,0.09744,0.704902,0
Ramos,Ramos,,103,103,206,103,103,206,2,0.527177,0.551552,0.000929,0.03232,0.03232,7,0.001023,0,0,0,0.10375,0.815733,0
Tahir,Tahir,,97,97,194,97,97,194,2,0.525513,0.548549,0.000824,0.030722,0.030722,3,0.000971,0,0,0,0.104381,0.775326,0
Saad Fiaz,Saad Fiaz,,100,100,200,100,100,200,2,0.526344,0.55005,0.000905,0.031143,0.031143,1,0.000999,0,0,0,0.098182,0.786091,0
Lexie,Lexie,,88,88,176,88,88,176,2,0.523037,0.544044,0.000671,0.027869,0.027869,0,0.000895,0,0,0,0.104493,0.70322,0
Johanssan,Johanssan,,90,90,180,90,90,180,2,0.523585,0.545045,0.000741,0.027891,0.027891,4,0.000914,0,0,0,0.092135,0.704127,0
Jake,Jake,,86,86,172,86,86,172,2,0.52249,0.543043,0.000664,0.026821,0.026821,0,0.000879,0,0,0,0.097401,0.677036,0
Quinn,Quinn,,104,104,208,104,104,208,2,0.527455,0.552052,0.000981,0.032413,0.032413,2,0.001032,0,0,0,0.097647,0.818128,0
Malik Belawal,Malik Belawal,,100,100,200,100,100,200,2,0.526344,0.55005,0.000857,0.031798,0.031798,2,0.000996,0,0,0,0.106465,0.802409,0
Mathew Perry,Mathew Perry,,115,115,230,115,115,230,2,0.530536,0.557558,0.001176,0.036122,0.036122,3,0.001124,0,0,0,0.104043,0.911584,0
Elenia,Elenia,,104,104,208,104,104,208,2,0.527455,0.552052,0.000941,0.033071,0.033071,7,0.00103,0,0,0,0.100075,0.834494,0
Ezad Khan,Ezad Khan,,87,87,174,87,87,174,2,0.522763,0.543544,0.000649,0.027656,0.027656,4,0.000886,0,0,0,0.107993,0.697869,0
Muhammad Musharaf,Muhammad Musharaf,,111,111,222,111,111,222,2,0.529412,0.555556,0.0011,0.034755,0.034755,4,0.001091,0,0,0,0.097625,0.877093,0
Asensio,Asensio,,86,86,172,86,86,172,2,0.52249,0.543043,0.000662,0.02674,0.02674,0,0.00088,0,0,0,0.103146,0.675076,0
Azhar Sadat,Azhar Sadat,,93,93,186,93,93,186,2,0.524409,0.546547,0.000778,0.029009,0.029009,0,0.000939,0,0,0,0.100748,0.732242,0
Raza Muhammadi,Raza Muhammadi,,99,99,198,99,99,198,2,0.526066,0.54955,0.000891,0.030704,0.030704,5,0.00099,0,0,0,0.099773,0.775092,0
Sufiyan,Sufiyan,,98,98,196,98,98,196,2,0.525789,0.549049,0.000882,0.03045,0.03045,2,0.000982,0,0,0,0.094046,0.768596,0
Najam,Najam,,94,94,188,94,94,188,2,0.524685,0.547047,0.000765,0.029699,0.029699,3,0.000946,0,0,0,0.10501,0.749449,0
Sye,Sye,,95,95,190,95,95,190,2,0.524961,0.547548,0.000796,0.029924,0.029924,0,0.000954,0,0,0,0.101904,0.755221,0
Muhammad Wasif,Muhammad Wasif,,107,107,214,107,107,214,2,0.528292,0.553554,0.001004,0.033877,0.033877,2,0.001055,0,0,0,0.099101,0.854812,0
Shama,Shama,,92,92,184,92,92,184,2,0.524134,0.546046,0.000731,0.028982,0.028982,0,0.000929,0,0,0,0.107262,0.731359,0
Henry,Henry,,100,100,200,100,100,200,2,0.526344,0.55005,0.000883,0.031399,0.031399,6,0.000998,0,0,0,0.104242,0.792373,0
Aiden,Aiden,,96,96,192,96,96,192,2,0.525237,0.548048,0.000811,0.030243,0.030243,7,0.000963,0,0,0,0.100658,0.763291,0
Ali Ghufron,Ali Ghufron,,96,96,192,96,96,192,2,0.525237,0.548048,0.000823,0.030064,0.030064,8,0.000964,0,0,0,0.101754,0.758915,0
Willow,Willow,,86,86,172,86,86,172,2,0.52249,0.543043,0.000648,0.027166,0.027166,0,0.000878,0,0,0,0.093023,0.685616,0
Doria,Doria,,109,109,218,109,109,218,2,0.528851,0.554555,0.00106,0.034201,0.034201,3,0.001074,0,0,0,0.101937,0.863178,0
Shabnam,Shabnam,,92,92,184,92,92,184,2,0.524134,0.546046,0.000759,0.02873,0.02873,4,0.00093,0,0,0,0.10129,0.725195,0
Bobby,Bobby,,109,109,218,109,109,218,2,0.528851,0.554555,0.001093,0.033813,0.033813,2,0.001076,0,0,0,0.092593,0.853471,0
Afifa,Afifa,,101,101,202,101,101,202,2,0.526621,0.550551,0.000922,0.031458,0.031458,7,0.001007,0,0,0,0.097822,0.793966,0
Ahmed Shahzad,Ahmed Shahzad,,95,95,190,95,95,190,2,0.524961,0.547548,0.000804,0.029854,0.029854,4,0.000955,0,0,0,0.09944,0.753406,0
Shakaib Butt,Shakaib Butt,,104,104,208,104,104,208,2,0.527455,0.552052,0.000957,0.03267,0.03267,8,0.001031,0,0,0,0.103622,0.824493,0
Celeste Hollenbach  ,Celeste Hollenbach  ,,102,102,204,102,102,204,2,0.526899,0.551051,0.000934,0.03199,0.03199,4,0.001014,0,0,0,0.09338,0.807363,0
Tasia Jeter  ,Tasia Jeter  ,,106,106,212,106,106,212,2,0.528013,0.553053,0.000999,0.033313,0.033313,4,0.001048,0,0,0,0.096855,0.840755,0
tillie,tillie,,103,103,206,103,103,206,2,0.527177,0.551552,0.000894,0.032933,0.032933,6,0.00102,0,0,0,0.1087,0.830754,0
Keely,Keely,,96,96,192,96,96,192,2,0.525237,0.548048,0.000798,0.030351,0.030351,8,0.000963,0,0,0,0.104825,0.765873,0
Eesa,Eesa,,86,86,172,86,86,172,2,0.52249,0.543043,0.000674,0.0265,0.0265,0,0.000881,0,0,0,0.099863,0.669135,0
Zia Khan,Zia Khan,,98,98,196,98,98,196,2,0.525789,0.549049,0.000852,0.03068,0.03068,5,0.00098,0,0,0,0.102462,0.774353,0
:ibbie,:ibbie,,119,119,238,119,119,238,2,0.531666,0.55956,0.001256,0.037392,0.037392,3,0.001158,0,0,0,0.102407,0.943567,0
Fahad Rehman,Fahad Rehman,,126,126,252,126,126,252,2,0.533654,0.563063,0.001416,0.039502,0.039502,2,0.001218,0,0,0,0.102349,0.996752,0
Katty,Katty,,107,107,214,107,107,214,2,0.528292,0.553554,0.001031,0.033391,0.033391,0,0.001057,0,0,0,0.09963,0.842799,0
Saba Jutt,Saba Jutt,,116,116,232,116,116,232,2,0.530818,0.558058,0.001172,0.036637,0.036637,1,0.001132,0,0,0,0.105847,0.924423,0
Alexandra,Alexandra,,89,89,178,89,89,178,2,0.523311,0.544545,0.000699,0.02798,0.02798,5,0.000904,0,0,0,0.104954,0.706172,0
Maison,Maison,,105,105,210,105,105,210,2,0.527734,0.552553,0.000971,0.032986,0.032986,7,0.001039,0,0,0,0.101099,0.832445,0
Ibrahim,Ibrahim,,99,99,198,99,99,198,2,0.526066,0.54955,0.000873,0.030875,0.030875,4,0.00099,0,0,0,0.108019,0.779405,0
Alina,Alina,,95,95,190,95,95,190,2,0.524961,0.547548,0.000776,0.030147,0.030147,2,0.000954,0,0,0,0.105039,0.760679,0
Theo,Theo,,95,95,190,95,95,190,2,0.524961,0.547548,0.000803,0.02988,0.02988,8,0.000955,0,0,0,0.092497,0.754062,0
Zobiya,Zobiya,,105,105,210,105,105,210,2,0.527734,0.552553,0.000981,0.032969,0.032969,2,0.001039,0,0,0,0.094872,0.832009,0
Lily,Lily,,82,82,164,82,82,164,2,0.521399,0.541041,0.000603,0.025579,0.025579,4,0.000846,0,0,0,0.100271,0.64562,0
Zachary,Zachary,,89,89,178,89,89,178,3,0.523037,0.544378,0.000721,0.027864,0.027864,4,0.000905,0,0,0,0.099336,0.703277,0
Mubashir,Mubashir,,98,98,196,98,98,196,2,0.525789,0.549049,0.000862,0.030585,0.030585,3,0.000981,0,0,0,0.09636,0.772004,0
Dextor,Dextor,,96,96,192,96,96,192,2,0.525237,0.548048,0.00082,0.030172,0.030172,2,0.000963,0,0,0,0.098684,0.76155,0
Maria,Maria,,92,92,184,92,92,184,2,0.524134,0.546046,0.000758,0.028824,0.028824,8,0.00093,0,0,0,0.095557,0.727647,0
Bailey,Bailey,,106,106,212,106,106,212,2,0.528013,0.553053,0.00097,0.033633,0.033633,1,0.001047,0,0,0,0.102606,0.848641,0
Audry,Audry,,114,114,228,114,114,228,2,0.530255,0.557057,0.001157,0.035782,0.035782,2,0.001116,0,0,0,0.102313,0.90295,0
Shoaib Khan,Shoaib Khan,,103,103,206,103,103,206,2,0.527177,0.551552,0.000948,0.032178,0.032178,4,0.001024,0,0,0,0.102798,0.812119,0
Finley,Finley,,99,99,198,99,99,198,2,0.526066,0.54955,0.000906,0.03046,0.03046,1,0.000991,0,0,0,0.096063,0.769053,0
Naja,Naja,,95,95,190,95,95,190,3,0.524685,0.547381,0.000784,0.029914,0.029914,2,0.000955,0,0,0,0.102352,0.754964,0
Purnama Putra,Purnama Putra,,98,98,196,98,98,196,2,0.525789,0.549049,0.000838,0.030844,0.030844,8,0.00098,0,0,0,0.106459,0.778308,0
KH Hassan,KH Hassan,,102,102,204,102,102,204,2,0.526899,0.551051,0.000924,0.0322,0.0322,8,0.001013,0,0,0,0.100175,0.812594,0
Gulshan,Gulshan,,107,107,214,107,107,214,2,0.528292,0.553554,0.001032,0.033326,0.033326,4,0.001058,0,0,0,0.101217,0.84112,0
Lacey,Lacey,,107,107,214,107,107,214,2,0.528292,0.553554,0.001016,0.033618,0.033618,8,0.001056,0,0,0,0.094692,0.848381,0
Riaz Ansari,Riaz Ansari,,89,89,178,89,89,178,2,0.523311,0.544545,0.000673,0.028357,0.028357,3,0.000903,0,0,0,0.108274,0.715507,0
Ethan,Ethan,,86,86,172,86,86,172,2,0.52249,0.543043,0.000636,0.027414,0.027415,4,0.000877,0,0,0,0.094118,0.691793,0
Arbab,Arbab,,96,96,192,96,96,192,2,0.525237,0.548048,0.00079,0.030538,0.030538,1,0.000962,0,0,0,0.103289,0.770568,0
Asep Jaja,Asep Jaja,,106,106,212,106,106,212,2,0.528013,0.553053,0.00099,0.033485,0.033485,5,0.001047,0,0,0,0.098293,0.844998,0
Muhammad Usman,Muhammad Usman,,101,101,202,101,101,202,2,0.526621,0.550551,0.000928,0.031384,0.031384,4,0.001007,0,0,0,0.100792,0.792188,0
Behraam,Behraam,,94,94,188,94,94,188,2,0.524685,0.547047,0.00077,0.029614,0.029614,2,0.000946,0,0,0,0.10318,0.747377,0
Jameela,Jameela,,96,96,192,96,96,192,2,0.525237,0.548048,0.000828,0.029917,0.029917,4,0.000965,0,0,0,0.106579,0.75513,0
Izaan,Izaan,,93,93,186,93,93,186,2,0.524409,0.546547,0.000751,0.029453,0.029453,1,0.000937,0,0,0,0.109631,0.743173,0
Jinsar Ali Shar,Jinsar Ali Shar,,104,104,208,104,104,208,2,0.527455,0.552052,0.000974,0.03253,0.03253,0,0.001032,0,0,0,0.094473,0.820955,0
Ollie,Ollie,,111,111,222,111,111,222,2,0.529412,0.555556,0.001092,0.034907,0.034907,0,0.00109,0,0,0,0.096151,0.880885,0
Samiullah,Samiullah,,107,107,214,107,107,214,2,0.528292,0.553554,0.00102,0.033496,0.033496,8,0.001057,0,0,0,0.10298,0.845291,0
Evelyn,Evelyn,,104,104,208,104,104,208,2,0.527455,0.552052,0.000952,0.032712,0.032712,7,0.001031,0,0,0,0.101195,0.825612,0
Faheem Ahmed,Faheem Ahmed,,88,88,176,88,88,176,2,0.523037,0.544044,0.000689,0.027437,0.027437,2,0.000896,0,0,0,0.106844,0.69254,0
Akash Parkash,Akash Parkash,,104,104,208,104,104,208,2,0.527455,0.552052,0.000962,0.032607,0.032607,0,0.001031,0,0,0,0.093727,0.822935,0
Hambali,Hambali,,86,86,172,86,86,172,3,0.522216,0.542876,0.000669,0.026713,0.026713,8,0.00088,0,0,0,0.103967,0.674367,0
Joko Triharmanto,Joko Triharmanto,,79,79,158,79,79,158,2,0.520584,0.53954,0.000539,0.025016,0.025016,2,0.000819,0,0,0,0.095748,0.631307,0
Bale,Bale,,99,99,198,99,99,198,2,0.526066,0.54955,0.000858,0.031275,0.031275,7,0.000988,0,0,0,0.095238,0.789219,0
Aiana,Aiana,,87,87,174,87,87,174,3,0.52249,0.543377,0.000658,0.027355,0.027355,4,0.000887,0,0,0,0.098102,0.690466,0
Saibi Malik,Saibi Malik,,98,98,196,98,98,196,2,0.525789,0.549049,0.000837,0.03097,0.03097,3,0.00098,0,0,0,0.098885,0.781586,0
Sheikh Madiha,Sheikh Madiha,,97,97,194,97,97,194,2,0.525513,0.548549,0.000833,0.030567,0.030567,3,0.000972,0,0,0,0.097723,0.771362,0
Alidha,Alidha,,105,105,210,105,105,210,2,0.527734,0.552553,0.000958,0.033288,0.033288,1,0.001038,0,0,0,0.102564,0.839951,0
Wajahat,Wajahat,,109,109,218,109,109,218,2,0.528851,0.554555,0.001046,0.034469,0.03447,5,0.001073,0,0,0,0.097689,0.869824,0
Haseeb,Haseeb,,97,97,194,97,97,194,2,0.525513,0.548549,0.000822,0.030558,0.030558,4,0.000971,0,0,0,0.099656,0.771171,0
Irun Hidayat,Irun Hidayat,,106,106,212,106,106,212,2,0.528013,0.553053,0.000975,0.033613,0.033613,8,0.001047,0,0,0,0.100809,0.84813,0
Danish,Danish,,92,92,184,92,92,184,2,0.524134,0.546046,0.000721,0.02923,0.02923,5,0.000928,0,0,0,0.10989,0.737504,0
Larissa,Larissa,,95,95,190,95,95,190,2,0.524961,0.547548,0.000779,0.030109,0.030109,2,0.000954,0,0,0,0.101232,0.759784,0
Milo,Milo,,91,91,182,91,91,182,2,0.523859,0.545546,0.000726,0.028754,0.028754,8,0.00092,0,0,0,0.100366,0.725576,0
Huzaifa Moughal,Huzaifa Moughal,,107,107,214,107,107,214,2,0.528292,0.553554,0.001008,0.033638,0.033638,6,0.001057,0,0,0,0.105978,0.848833,0
Umar Patek,Umar Patek,,106,106,212,106,106,212,2,0.528013,0.553053,0.001005,0.033189,0.033189,4,0.001049,0,0,0,0.09991,0.837649,0
Ali Ahmad,Ali Ahmad,,95,95,190,95,95,190,2,0.524961,0.547548,0.000794,0.02977,0.02977,2,0.000955,0,0,0,0.096753,0.751362,0
Kiran,Kiran,,96,96,192,96,96,192,2,0.525237,0.548048,0.000816,0.030229,0.030229,3,0.000963,0,0,0,0.099781,0.762934,0
Aneela,Aneela,,120,120,240,120,120,240,2,0.531949,0.56006,0.001272,0.037788,0.037788,5,0.001166,0,0,0,0.098739,0.953561,0
Mohamed Ihsan,Mohamed Ihsan,,98,98,196,98,98,196,2,0.525789,0.549049,0.000869,0.030507,0.030507,2,0.000981,0,0,0,0.099726,0.769969,0
Muzammil,Muzammil,,96,96,192,96,96,192,2,0.525237,0.548048,0.000824,0.030077,0.030077,3,0.000964,0,0,0,0.102851,0.759093,0
Fe Raymond  ,Fe Raymond  ,,96,96,192,96,96,192,2,0.525237,0.548048,0.000813,0.030164,0.030164,6,0.000963,0,0,0,0.100219,0.761234,0
Tohir,Tohir,,85,85,170,85,85,170,2,0.522216,0.542543,0.000612,0.027093,0.027093,5,0.000869,0,0,0,0.107003,0.683628,0
Usman Ahmed,Usman Ahmed,,102,102,204,102,102,204,2,0.526899,0.551051,0.000935,0.03198,0.03198,6,0.001015,0,0,0,0.100175,0.807114,0
Shayan,Shayan,,94,94,188,94,94,188,3,0.524409,0.54688,0.000764,0.029817,0.029817,0,0.000945,0,0,0,0.105697,0.75241,0
Julia,Julia,,95,95,190,95,95,190,2,0.524961,0.547548,0.000808,0.029577,0.029577,1,0.000956,0,0,0,0.108399,0.746559,0
Rohail,Rohail,,94,94,188,94,94,188,2,0.524685,0.547047,0.000789,0.029433,0.029433,7,0.000947,0,0,0,0.097461,0.742891,0
Sami Satti,Sami Satti,,88,88,176,88,88,176,2,0.523037,0.544044,0.000675,0.027748,0.027748,6,0.000895,0,0,0,0.105799,0.700253,0
Dana,Dana,,88,88,176,88,88,176,2,0.523037,0.544044,0.000691,0.027426,0.027426,4,0.000896,0,0,0,0.102403,0.692244,0
